"Datum";"Region";"PCR_Pos";"Ag_Neg";"Ag_Pos";"Total";"Pocet.potvrdenych";"Potvrdenych";"newcases";"date";"positive"
2021-02-11;"Banskobystrický kraj";305;16227;287;16514;25324;48860;592;2021-02-11;48860
2021-02-10;"Banskobystrický kraj";333;12285;295;12580;NA;48860;628;2021-02-10;48268
2021-02-09;"Banskobystrický kraj";329;17276;325;17601;NA;48860;654;2021-02-09;47640
2021-02-08;"Banskobystrický kraj";103;40899;589;41488;NA;48860;692;2021-02-08;46986
2021-02-07;"Banskobystrický kraj";70;22785;137;22922;NA;48860;207;2021-02-07;46294
2021-02-06;"Banskobystrický kraj";178;62133;535;62668;NA;48860;713;2021-02-06;46087
2021-02-05;"Banskobystrický kraj";282;23552;358;23910;NA;48860;640;2021-02-05;45374
2021-02-04;"Banskobystrický kraj";240;13170;413;13583;NA;48860;653;2021-02-04;44734
2021-02-03;"Banskobystrický kraj";350;9060;243;9303;NA;48860;593;2021-02-03;44081
2021-02-02;"Banskobystrický kraj";277;14531;319;14850;NA;48860;596;2021-02-02;43488
2021-02-01;"Banskobystrický kraj";75;19039;379;19418;NA;48860;454;2021-02-01;42892
2021-01-31;"Banskobystrický kraj";34;24501;219;24720;NA;48860;253;2021-01-31;42438
2021-01-30;"Banskobystrický kraj";163;45964;379;46343;NA;48860;542;2021-01-30;42185
2021-01-29;"Banskobystrický kraj";130;15194;237;15431;NA;48860;367;2021-01-29;41643
2021-01-28;"Banskobystrický kraj";218;13804;342;14146;NA;48860;560;2021-01-28;41276
2021-01-27;"Banskobystrický kraj";191;10631;197;10828;NA;48860;388;2021-01-27;40716
2021-01-26;"Banskobystrický kraj";238;19646;288;19934;NA;48860;526;2021-01-26;40328
2021-01-25;"Banskobystrický kraj";82;31377;369;31746;NA;48860;451;2021-01-25;39802
2021-01-24;"Banskobystrický kraj";38;29106;239;29345;NA;48860;277;2021-01-24;39351
2021-01-23;"Banskobystrický kraj";142;83050;503;83553;NA;48860;645;2021-01-23;39074
2021-01-22;"Banskobystrický kraj";175;26799;341;27140;NA;48860;516;2021-01-22;38429
2021-01-21;"Banskobystrický kraj";194;16009;351;16360;NA;48860;545;2021-01-21;37913
2021-01-20;"Banskobystrický kraj";231;8860;186;9046;NA;48860;417;2021-01-20;37368
2021-01-19;"Banskobystrický kraj";213;10646;321;10967;NA;48860;534;2021-01-19;36951
2021-01-18;"Banskobystrický kraj";94;5171;277;5448;NA;48860;371;2021-01-18;36417
2021-01-17;"Banskobystrický kraj";110;8150;77;8227;NA;48860;187;2021-01-17;36046
2021-01-16;"Banskobystrický kraj";58;1873;56;1929;NA;48860;114;2021-01-16;35859
2021-01-15;"Banskobystrický kraj";164;6312;203;6515;NA;48860;367;2021-01-15;35745
2021-01-14;"Banskobystrický kraj";220;5443;320;5763;NA;48860;540;2021-01-14;35378
2021-01-13;"Banskobystrický kraj";235;5560;191;5751;NA;48860;426;2021-01-13;34838
2021-01-12;"Banskobystrický kraj";194;6298;287;6585;NA;48860;481;2021-01-12;34412
2021-01-11;"Banskobystrický kraj";76;7034;411;7445;NA;48860;487;2021-01-11;33931
2021-01-10;"Banskobystrický kraj";110;102;4;106;NA;48860;114;2021-01-10;33444
2021-01-09;"Banskobystrický kraj";297;2728;107;2835;NA;48860;404;2021-01-09;33330
2021-01-08;"Banskobystrický kraj";435;8076;383;8459;NA;48860;818;2021-01-08;32926
2021-01-07;"Banskobystrický kraj";127;4037;260;4297;NA;48860;387;2021-01-07;32108
2021-01-06;"Banskobystrický kraj";305;3369;210;3579;NA;48860;515;2021-01-06;31721
2021-01-05;"Banskobystrický kraj";372;6380;480;6860;NA;48860;852;2021-01-05;31206
2021-01-04;"Banskobystrický kraj";130;5762;571;6333;NA;48860;701;2021-01-04;30354
2021-01-03;"Banskobystrický kraj";199;162;13;175;NA;48860;212;2021-01-03;29653
2021-01-02;"Banskobystrický kraj";123;583;83;666;NA;48860;206;2021-01-02;29441
2021-01-01;"Banskobystrický kraj";220;2015;135;2150;NA;48860;355;2021-01-01;29235
2020-12-31;"Banskobystrický kraj";499;6796;724;7520;NA;48860;1223;2020-12-31;28880
2020-12-30;"Banskobystrický kraj";593;7101;536;7637;NA;48860;1129;2020-12-30;27657
2020-12-29;"Banskobystrický kraj";240;7590;738;8328;NA;48860;978;2020-12-29;26528
2020-12-28;"Banskobystrický kraj";131;5575;674;6249;NA;48860;805;2020-12-28;25550
2020-12-27;"Banskobystrický kraj";116;496;25;521;NA;48860;141;2020-12-27;24745
2020-12-26;"Banskobystrický kraj";61;259;32;291;NA;48860;93;2020-12-26;24604
2020-12-25;"Banskobystrický kraj";65;229;6;235;NA;48860;71;2020-12-25;24511
2020-12-24;"Banskobystrický kraj";452;3674;135;3809;NA;48860;587;2020-12-24;24440
2020-12-23;"Banskobystrický kraj";368;9388;470;9858;NA;48860;838;2020-12-23;23853
2020-12-22;"Banskobystrický kraj";307;8300;624;8924;NA;48860;931;2020-12-22;23015
2020-12-21;"Banskobystrický kraj";286;4898;448;5346;NA;48860;734;2020-12-21;22084
2020-12-20;"Banskobystrický kraj";155;99;14;113;NA;48860;169;2020-12-20;21350
2020-12-19;"Banskobystrický kraj";170;2488;565;3053;NA;48860;735;2020-12-19;21181
2020-12-18;"Banskobystrický kraj";432;6454;414;6868;NA;48860;846;2020-12-18;20446
2020-12-17;"Banskobystrický kraj";468;8474;772;9246;NA;48860;1240;2020-12-17;19600
2020-12-16;"Banskobystrický kraj";379;10080;557;10637;NA;48860;936;2020-12-16;18360
2020-12-15;"Banskobystrický kraj";336;5318;430;5748;NA;48860;766;2020-12-15;17424
2020-12-14;"Banskobystrický kraj";148;3733;259;3992;NA;48860;407;2020-12-14;16658
2020-12-13;"Banskobystrický kraj";122;19;1;20;NA;48860;123;2020-12-13;16251
2020-12-12;"Banskobystrický kraj";137;2594;138;2732;NA;48860;275;2020-12-12;16128
2020-12-11;"Banskobystrický kraj";468;6443;374;6817;NA;48860;842;2020-12-11;15853
2020-12-10;"Banskobystrický kraj";280;5027;351;5378;NA;48860;631;2020-12-10;15011
2020-12-09;"Banskobystrický kraj";323;3707;212;3919;NA;48860;535;2020-12-09;14380
2020-12-08;"Banskobystrický kraj";256;3667;276;3943;NA;48860;532;2020-12-08;13845
2020-12-07;"Banskobystrický kraj";175;2006;140;2146;NA;48860;315;2020-12-07;13313
2020-12-06;"Banskobystrický kraj";121;359;9;368;NA;48860;130;2020-12-06;12998
2020-12-05;"Banskobystrický kraj";109;952;33;985;NA;48860;142;2020-12-05;12868
2020-12-04;"Banskobystrický kraj";339;3723;174;3897;NA;48860;513;2020-12-04;12726
2020-12-03;"Banskobystrický kraj";240;2913;227;3140;NA;48860;467;2020-12-03;12213
2020-12-02;"Banskobystrický kraj";217;4292;186;4478;NA;48860;403;2020-12-02;11746
2020-12-01;"Banskobystrický kraj";215;2619;134;2753;NA;48860;349;2020-12-01;11343
2020-11-30;"Banskobystrický kraj";75;3761;226;3987;NA;48860;301;2020-11-30;10994
2020-11-29;"Banskobystrický kraj";19;80;3;83;NA;48860;22;2020-11-29;10693
2020-11-28;"Banskobystrický kraj";81;1279;48;1327;NA;48860;129;2020-11-28;10671
2020-11-27;"Banskobystrický kraj";219;1930;120;2050;NA;48860;339;2020-11-27;10542
2020-11-26;"Banskobystrický kraj";209;1855;91;1946;NA;48860;300;2020-11-26;10203
2020-11-25;"Banskobystrický kraj";170;1760;84;1844;NA;48860;254;2020-11-25;9903
2020-11-24;"Banskobystrický kraj";166;2262;67;2329;NA;48860;233;2020-11-24;9649
2020-11-23;"Banskobystrický kraj";66;9948;191;10139;NA;48860;257;2020-11-23;9416
2020-11-22;"Banskobystrický kraj";38;72;1;73;NA;48860;39;2020-11-22;9159
2020-11-21;"Banskobystrický kraj";52;885;14;899;NA;48860;66;2020-11-21;9120
2020-11-20;"Banskobystrický kraj";127;1872;105;1977;NA;48860;232;2020-11-20;9054
2020-11-19;"Banskobystrický kraj";170;1112;82;1194;NA;48860;252;2020-11-19;8822
2020-11-18;"Banskobystrický kraj";153;587;62;649;NA;48860;215;2020-11-18;8570
2020-11-17;"Banskobystrický kraj";52;578;35;613;NA;48860;87;2020-11-17;8355
2020-11-16;"Banskobystrický kraj";106;351;22;373;NA;48860;128;2020-11-16;8268
2020-11-15;"Banskobystrický kraj";52;64;2;66;NA;48860;54;2020-11-15;8140
2020-11-14;"Banskobystrický kraj";73;305;2;307;NA;48860;75;2020-11-14;8086
2020-11-13;"Banskobystrický kraj";157;552;11;563;NA;48860;168;2020-11-13;8011
2020-11-12;"Banskobystrický kraj";218;952;44;996;NA;48860;262;2020-11-12;7843
2020-11-11;"Banskobystrický kraj";224;437;9;446;NA;48860;233;2020-11-11;7581
2020-11-10;"Banskobystrický kraj";263;463;18;481;NA;48860;281;2020-11-10;7348
2020-11-09;"Banskobystrický kraj";80;2678;31;2709;NA;48860;111;2020-11-09;7067
2020-11-08;"Banskobystrický kraj";82;783;16;799;NA;48860;98;2020-11-08;6956
2020-11-07;"Banskobystrický kraj";164;8828;94;8922;NA;48860;258;2020-11-07;6858
2020-11-06;"Banskobystrický kraj";227;2496;16;2512;NA;48860;243;2020-11-06;6600
2020-11-05;"Banskobystrický kraj";240;263;33;296;NA;48860;273;2020-11-05;6357
2020-11-04;"Banskobystrický kraj";254;1366;13;1379;NA;48860;267;2020-11-04;6084
2020-11-03;"Banskobystrický kraj";246;1332;4;1336;NA;48860;250;2020-11-03;5817
2020-11-02;"Banskobystrický kraj";90;2247;65;2312;NA;48860;155;2020-11-02;5567
2020-11-01;"Banskobystrický kraj";101;2671;42;2713;NA;48860;143;2020-11-01;5412
2020-10-31;"Banskobystrický kraj";198;13516;116;13632;NA;48860;314;2020-10-31;5269
2020-10-30;"Banskobystrický kraj";254;2829;20;2849;NA;48860;274;2020-10-30;4955
2020-10-29;"Banskobystrický kraj";372;969;42;1011;NA;48860;414;2020-10-29;4681
2020-10-28;"Banskobystrický kraj";285;302;30;332;NA;48860;315;2020-10-28;4267
2020-10-27;"Banskobystrický kraj";266;654;40;694;NA;48860;306;2020-10-27;3952
2020-10-26;"Banskobystrický kraj";38;232;29;261;NA;48860;67;2020-10-26;3646
2020-10-25;"Banskobystrický kraj";50;140;11;151;NA;48860;61;2020-10-25;3579
2020-10-24;"Banskobystrický kraj";315;114;12;126;NA;48860;327;2020-10-24;3518
2020-10-23;"Banskobystrický kraj";231;230;29;259;NA;48860;260;2020-10-23;3191
2020-10-22;"Banskobystrický kraj";264;253;24;277;NA;48860;288;2020-10-22;2931
2020-10-21;"Banskobystrický kraj";209;266;3;269;NA;48860;212;2020-10-21;2643
2020-10-20;"Banskobystrický kraj";210;66;3;69;NA;48860;213;2020-10-20;2431
2020-10-19;"Banskobystrický kraj";27;71;12;83;NA;48860;39;2020-10-19;2218
2020-10-18;"Banskobystrický kraj";49;0;0;0;NA;48860;49;2020-10-18;2179
2020-10-17;"Banskobystrický kraj";91;0;0;0;NA;48860;91;2020-10-17;2130
2020-10-16;"Banskobystrický kraj";224;37;3;40;NA;48860;227;2020-10-16;2039
2020-10-15;"Banskobystrický kraj";133;29;1;30;NA;48860;134;2020-10-15;1812
2020-10-14;"Banskobystrický kraj";139;31;1;32;NA;48860;140;2020-10-14;1678
2020-10-13;"Banskobystrický kraj";151;169;11;180;NA;48860;162;2020-10-13;1538
2020-10-12;"Banskobystrický kraj";11;13;0;13;NA;48860;11;2020-10-12;1376
2020-10-11;"Banskobystrický kraj";14;0;0;0;NA;48860;14;2020-10-11;1365
2020-10-10;"Banskobystrický kraj";53;0;0;0;NA;48860;53;2020-10-10;1351
2020-10-09;"Banskobystrický kraj";128;0;0;0;NA;48860;128;2020-10-09;1298
2020-10-08;"Banskobystrický kraj";99;0;0;0;NA;48860;99;2020-10-08;1170
2020-10-07;"Banskobystrický kraj";124;0;0;0;NA;48860;124;2020-10-07;1071
2020-10-06;"Banskobystrický kraj";68;0;0;0;NA;48860;68;2020-10-06;947
2020-10-05;"Banskobystrický kraj";49;0;0;0;NA;48860;49;2020-10-05;879
2020-10-04;"Banskobystrický kraj";8;0;0;0;NA;48860;8;2020-10-04;830
2020-10-03;"Banskobystrický kraj";37;0;0;0;NA;48860;37;2020-10-03;822
2020-10-02;"Banskobystrický kraj";74;0;0;0;NA;48860;74;2020-10-02;785
2020-10-01;"Banskobystrický kraj";49;0;0;0;NA;48860;49;2020-10-01;711
2020-09-30;"Banskobystrický kraj";60;0;0;0;NA;48860;60;2020-09-30;662
2020-09-29;"Banskobystrický kraj";24;0;0;0;NA;48860;24;2020-09-29;602
2020-09-27;"Banskobystrický kraj";20;0;0;0;NA;48860;20;2020-09-27;578
2020-09-26;"Banskobystrický kraj";24;0;0;0;NA;48860;24;2020-09-26;558
2020-09-25;"Banskobystrický kraj";29;0;0;0;NA;48860;29;2020-09-25;534
2020-09-24;"Banskobystrický kraj";25;0;0;0;NA;48860;25;2020-09-24;505
2020-09-23;"Banskobystrický kraj";17;0;0;0;NA;48860;17;2020-09-23;480
2020-09-22;"Banskobystrický kraj";25;0;0;0;NA;48860;25;2020-09-22;463
2020-09-21;"Banskobystrický kraj";3;0;0;0;NA;48860;3;2020-09-21;438
2020-09-19;"Banskobystrický kraj";3;0;0;0;NA;48860;3;2020-09-19;435
2020-09-18;"Banskobystrický kraj";24;0;0;0;NA;48860;24;2020-09-18;432
2020-09-17;"Banskobystrický kraj";14;0;0;0;NA;48860;14;2020-09-17;408
2020-09-16;"Banskobystrický kraj";6;0;0;0;NA;48860;6;2020-09-16;394
2020-09-15;"Banskobystrický kraj";2;0;0;0;NA;48860;2;2020-09-15;388
2020-09-14;"Banskobystrický kraj";13;0;0;0;NA;48860;13;2020-09-14;386
2020-09-13;"Banskobystrický kraj";1;0;0;0;NA;48860;1;2020-09-13;373
2020-09-12;"Banskobystrický kraj";5;0;0;0;NA;48860;5;2020-09-12;372
2020-09-11;"Banskobystrický kraj";19;0;0;0;NA;48860;19;2020-09-11;367
2020-09-10;"Banskobystrický kraj";11;0;0;0;NA;48860;11;2020-09-10;348
2020-09-09;"Banskobystrický kraj";13;0;0;0;NA;48860;13;2020-09-09;337
2020-09-08;"Banskobystrický kraj";5;0;0;0;NA;48860;5;2020-09-08;324
2020-09-07;"Banskobystrický kraj";2;0;0;0;NA;48860;2;2020-09-07;319
2020-09-04;"Banskobystrický kraj";9;0;0;0;NA;48860;9;2020-09-04;317
2020-09-03;"Banskobystrický kraj";5;0;0;0;NA;48860;5;2020-09-03;308
2021-02-11;"Bratislavský kraj";337;15002;198;15200;33335;59578;535;2021-02-11;59578
2021-02-10;"Bratislavský kraj";314;18495;290;18785;NA;59578;604;2021-02-10;59043
2021-02-09;"Bratislavský kraj";287;30481;367;30848;NA;59578;654;2021-02-09;58439
2021-02-08;"Bratislavský kraj";484;32289;365;32654;NA;59578;849;2021-02-08;57785
2021-02-07;"Bratislavský kraj";243;44778;372;45150;NA;59578;615;2021-02-07;56936
2021-02-06;"Bratislavský kraj";116;54125;445;54570;NA;59578;561;2021-02-06;56321
2021-02-05;"Bratislavský kraj";327;22688;315;23003;NA;59578;642;2021-02-05;55760
2021-02-04;"Bratislavský kraj";555;13887;308;14195;NA;59578;863;2021-02-04;55118
2021-02-03;"Bratislavský kraj";161;11204;284;11488;NA;59578;445;2021-02-03;54255
2021-02-02;"Bratislavský kraj";397;26016;382;26398;NA;59578;779;2021-02-02;53810
2021-02-01;"Bratislavský kraj";221;37524;473;37997;NA;59578;694;2021-02-01;53031
2021-01-31;"Bratislavský kraj";180;32363;373;32736;NA;59578;553;2021-01-31;52337
2021-01-30;"Bratislavský kraj";310;35327;376;35703;NA;59578;686;2021-01-30;51784
2021-01-29;"Bratislavský kraj";82;14562;323;14885;NA;59578;405;2021-01-29;51098
2021-01-28;"Bratislavský kraj";307;10148;289;10437;NA;59578;596;2021-01-28;50693
2021-01-27;"Bratislavský kraj";336;22701;348;23049;NA;59578;684;2021-01-27;50097
2021-01-26;"Bratislavský kraj";297;22244;294;22538;NA;59578;591;2021-01-26;49413
2021-01-25;"Bratislavský kraj";356;24117;270;24387;NA;59578;626;2021-01-25;48822
2021-01-24;"Bratislavský kraj";175;33096;332;33428;NA;59578;507;2021-01-24;48196
2021-01-23;"Bratislavský kraj";396;70362;599;70961;NA;59578;995;2021-01-23;47689
2021-01-22;"Bratislavský kraj";199;39236;341;39577;NA;59578;540;2021-01-22;46694
2021-01-21;"Bratislavský kraj";255;103763;1292;105055;NA;59578;1547;2021-01-21;46154
2021-01-20;"Bratislavský kraj";360;27647;465;28112;NA;59578;825;2021-01-20;44607
2021-01-19;"Bratislavský kraj";375;13357;322;13679;NA;59578;697;2021-01-19;43782
2021-01-18;"Bratislavský kraj";357;10651;700;11351;NA;59578;1057;2021-01-18;43085
2021-01-17;"Bratislavský kraj";244;286;26;312;NA;59578;270;2021-01-17;42028
2021-01-16;"Bratislavský kraj";70;2705;148;2853;NA;59578;218;2021-01-16;41758
2021-01-15;"Bratislavský kraj";251;7061;236;7297;NA;59578;487;2021-01-15;41540
2021-01-14;"Bratislavský kraj";363;8078;273;8351;NA;59578;636;2021-01-14;41053
2021-01-13;"Bratislavský kraj";336;17791;413;18204;NA;59578;749;2021-01-13;40417
2021-01-12;"Bratislavský kraj";450;9435;463;9898;NA;59578;913;2021-01-12;39668
2021-01-11;"Bratislavský kraj";397;8902;312;9214;NA;59578;709;2021-01-11;38755
2021-01-10;"Bratislavský kraj";252;1341;79;1420;NA;59578;331;2021-01-10;38046
2021-01-09;"Bratislavský kraj";351;4944;291;5235;NA;59578;642;2021-01-09;37715
2021-01-08;"Bratislavský kraj";556;8817;441;9258;NA;59578;997;2021-01-08;37073
2021-01-07;"Bratislavský kraj";537;6885;424;7309;NA;59578;961;2021-01-07;36076
2021-01-06;"Bratislavský kraj";271;2968;210;3178;NA;59578;481;2021-01-06;35115
2021-01-05;"Bratislavský kraj";619;11345;854;12199;NA;59578;1473;2021-01-05;34634
2021-01-04;"Bratislavský kraj";601;7114;626;7740;NA;59578;1227;2021-01-04;33161
2021-01-03;"Bratislavský kraj";77;596;79;675;NA;59578;156;2021-01-03;31934
2021-01-02;"Bratislavský kraj";185;163;18;181;NA;59578;203;2021-01-02;31778
2021-01-01;"Bratislavský kraj";235;3143;130;3273;NA;59578;365;2021-01-01;31575
2020-12-31;"Bratislavský kraj";925;13251;562;13813;NA;59578;1487;2020-12-31;31210
2020-12-30;"Bratislavský kraj";650;9196;518;9714;NA;59578;1168;2020-12-30;29723
2020-12-29;"Bratislavský kraj";303;10407;770;11177;NA;59578;1073;2020-12-29;28555
2020-12-28;"Bratislavský kraj";255;7608;559;8167;NA;59578;814;2020-12-28;27482
2020-12-27;"Bratislavský kraj";160;549;67;616;NA;59578;227;2020-12-27;26668
2020-12-26;"Bratislavský kraj";75;416;23;439;NA;59578;98;2020-12-26;26441
2020-12-25;"Bratislavský kraj";114;460;38;498;NA;59578;152;2020-12-25;26343
2020-12-24;"Bratislavský kraj";536;4112;122;4234;NA;59578;658;2020-12-24;26191
2020-12-23;"Bratislavský kraj";416;12067;482;12549;NA;59578;898;2020-12-23;25533
2020-12-22;"Bratislavský kraj";327;14938;764;15702;NA;59578;1091;2020-12-22;24635
2020-12-21;"Bratislavský kraj";392;14725;1998;16723;NA;59578;2390;2020-12-21;23544
2020-12-20;"Bratislavský kraj";180;558;52;610;NA;59578;232;2020-12-20;21154
2020-12-19;"Bratislavský kraj";396;3150;129;3279;NA;59578;525;2020-12-19;20922
2020-12-18;"Bratislavský kraj";306;11002;420;11422;NA;59578;726;2020-12-18;20397
2020-12-17;"Bratislavský kraj";502;8783;377;9160;NA;59578;879;2020-12-17;19671
2020-12-16;"Bratislavský kraj";282;9893;428;10321;NA;59578;710;2020-12-16;18792
2020-12-15;"Bratislavský kraj";423;10277;471;10748;NA;59578;894;2020-12-15;18082
2020-12-14;"Bratislavský kraj";279;6208;295;6503;NA;59578;574;2020-12-14;17188
2020-12-13;"Bratislavský kraj";125;108;7;115;NA;59578;132;2020-12-13;16614
2020-12-12;"Bratislavský kraj";361;3734;157;3891;NA;59578;518;2020-12-12;16482
2020-12-11;"Bratislavský kraj";326;7059;305;7364;NA;59578;631;2020-12-11;15964
2020-12-10;"Bratislavský kraj";286;4996;219;5215;NA;59578;505;2020-12-10;15333
2020-12-09;"Bratislavský kraj";382;5249;207;5456;NA;59578;589;2020-12-09;14828
2020-12-08;"Bratislavský kraj";234;5427;197;5624;NA;59578;431;2020-12-08;14239
2020-12-07;"Bratislavský kraj";272;4345;168;4513;NA;59578;440;2020-12-07;13808
2020-12-06;"Bratislavský kraj";61;1584;52;1636;NA;59578;113;2020-12-06;13368
2020-12-05;"Bratislavský kraj";266;2144;41;2185;NA;59578;307;2020-12-05;13255
2020-12-04;"Bratislavský kraj";200;4511;104;4615;NA;59578;304;2020-12-04;12948
2020-12-03;"Bratislavský kraj";213;5036;102;5138;NA;59578;315;2020-12-03;12644
2020-12-02;"Bratislavský kraj";204;2452;135;2587;NA;59578;339;2020-12-02;12329
2020-12-01;"Bratislavský kraj";255;3305;168;3473;NA;59578;423;2020-12-01;11990
2020-11-30;"Bratislavský kraj";152;1727;103;1830;NA;59578;255;2020-11-30;11567
2020-11-29;"Bratislavský kraj";52;41;21;62;NA;59578;73;2020-11-29;11312
2020-11-28;"Bratislavský kraj";232;1983;21;2004;NA;59578;253;2020-11-28;11239
2020-11-27;"Bratislavský kraj";54;1198;29;1227;NA;59578;83;2020-11-27;10986
2020-11-26;"Bratislavský kraj";129;1114;25;1139;NA;59578;154;2020-11-26;10903
2020-11-25;"Bratislavský kraj";140;1133;31;1164;NA;59578;171;2020-11-25;10749
2020-11-24;"Bratislavský kraj";81;2988;67;3055;NA;59578;148;2020-11-24;10578
2020-11-23;"Bratislavský kraj";67;7077;58;7135;NA;59578;125;2020-11-23;10430
2020-11-22;"Bratislavský kraj";36;81;7;88;NA;59578;43;2020-11-22;10305
2020-11-21;"Bratislavský kraj";109;2126;47;2173;NA;59578;156;2020-11-21;10262
2020-11-20;"Bratislavský kraj";118;2869;48;2917;NA;59578;166;2020-11-20;10106
2020-11-19;"Bratislavský kraj";173;987;29;1016;NA;59578;202;2020-11-19;9940
2020-11-18;"Bratislavský kraj";118;616;75;691;NA;59578;193;2020-11-18;9738
2020-11-17;"Bratislavský kraj";108;928;23;951;NA;59578;131;2020-11-17;9545
2020-11-16;"Bratislavský kraj";82;651;9;660;NA;59578;91;2020-11-16;9414
2020-11-15;"Bratislavský kraj";47;236;0;236;NA;59578;47;2020-11-15;9323
2020-11-14;"Bratislavský kraj";53;1834;15;1849;NA;59578;68;2020-11-14;9276
2020-11-13;"Bratislavský kraj";94;2096;21;2117;NA;59578;115;2020-11-13;9208
2020-11-12;"Bratislavský kraj";141;1727;6;1733;NA;59578;147;2020-11-12;9093
2020-11-11;"Bratislavský kraj";159;1429;12;1441;NA;59578;171;2020-11-11;8946
2020-11-10;"Bratislavský kraj";136;805;14;819;NA;59578;150;2020-11-10;8775
2020-11-09;"Bratislavský kraj";70;609;8;617;NA;59578;78;2020-11-09;8625
2020-11-08;"Bratislavský kraj";82;869;6;875;NA;59578;88;2020-11-08;8547
2020-11-07;"Bratislavský kraj";88;4039;17;4056;NA;59578;105;2020-11-07;8459
2020-11-06;"Bratislavský kraj";281;6441;25;6466;NA;59578;306;2020-11-06;8354
2020-11-05;"Bratislavský kraj";175;476;11;487;NA;59578;186;2020-11-05;8048
2020-11-04;"Bratislavský kraj";65;411;10;421;NA;59578;75;2020-11-04;7862
2020-11-03;"Bratislavský kraj";251;1081;12;1093;NA;59578;263;2020-11-03;7787
2020-11-02;"Bratislavský kraj";202;3365;22;3387;NA;59578;224;2020-11-02;7524
2020-11-01;"Bratislavský kraj";227;8694;39;8733;NA;59578;266;2020-11-01;7300
2020-10-31;"Bratislavský kraj";173;22407;123;22530;NA;59578;296;2020-10-31;7034
2020-10-30;"Bratislavský kraj";158;17350;138;17488;NA;59578;296;2020-10-30;6738
2020-10-29;"Bratislavský kraj";262;116;4;120;NA;59578;266;2020-10-29;6442
2020-10-28;"Bratislavský kraj";220;260;15;275;NA;59578;235;2020-10-28;6176
2020-10-27;"Bratislavský kraj";256;145;4;149;NA;59578;260;2020-10-27;5941
2020-10-26;"Bratislavský kraj";123;229;11;240;NA;59578;134;2020-10-26;5681
2020-10-25;"Bratislavský kraj";152;33;2;35;NA;59578;154;2020-10-25;5547
2020-10-24;"Bratislavský kraj";170;221;6;227;NA;59578;176;2020-10-24;5393
2020-10-23;"Bratislavský kraj";151;144;8;152;NA;59578;159;2020-10-23;5217
2020-10-22;"Bratislavský kraj";192;204;15;219;NA;59578;207;2020-10-22;5058
2020-10-21;"Bratislavský kraj";66;90;6;96;NA;59578;72;2020-10-21;4851
2020-10-20;"Bratislavský kraj";183;97;4;101;NA;59578;187;2020-10-20;4779
2020-10-19;"Bratislavský kraj";148;80;3;83;NA;59578;151;2020-10-19;4592
2020-10-18;"Bratislavský kraj";75;92;0;92;NA;59578;75;2020-10-18;4441
2020-10-17;"Bratislavský kraj";136;0;0;0;NA;59578;136;2020-10-17;4366
2020-10-16;"Bratislavský kraj";103;14;1;15;NA;59578;104;2020-10-16;4230
2020-10-15;"Bratislavský kraj";135;6;1;7;NA;59578;136;2020-10-15;4126
2020-10-14;"Bratislavský kraj";127;4;0;4;NA;59578;127;2020-10-14;3990
2020-10-13;"Bratislavský kraj";86;108;8;116;NA;59578;94;2020-10-13;3863
2020-10-12;"Bratislavský kraj";46;0;0;0;NA;59578;46;2020-10-12;3769
2020-10-11;"Bratislavský kraj";80;0;0;0;NA;59578;80;2020-10-11;3723
2020-10-10;"Bratislavský kraj";55;0;0;0;NA;59578;55;2020-10-10;3643
2020-10-09;"Bratislavský kraj";148;0;0;0;NA;59578;148;2020-10-09;3588
2020-10-08;"Bratislavský kraj";100;0;0;0;NA;59578;100;2020-10-08;3440
2020-10-07;"Bratislavský kraj";107;0;0;0;NA;59578;107;2020-10-07;3340
2020-10-06;"Bratislavský kraj";108;0;0;0;NA;59578;108;2020-10-06;3233
2020-10-05;"Bratislavský kraj";30;0;0;0;NA;59578;30;2020-10-05;3125
2020-10-04;"Bratislavský kraj";49;0;0;0;NA;59578;49;2020-10-04;3095
2020-10-03;"Bratislavský kraj";82;0;0;0;NA;59578;82;2020-10-03;3046
2020-10-02;"Bratislavský kraj";101;0;0;0;NA;59578;101;2020-10-02;2964
2020-10-01;"Bratislavský kraj";72;0;0;0;NA;59578;72;2020-10-01;2863
2020-09-30;"Bratislavský kraj";91;0;0;0;NA;59578;91;2020-09-30;2791
2020-09-29;"Bratislavský kraj";74;0;0;0;NA;59578;74;2020-09-29;2700
2020-09-28;"Bratislavský kraj";29;0;0;0;NA;59578;29;2020-09-28;2626
2020-09-27;"Bratislavský kraj";48;0;0;0;NA;59578;48;2020-09-27;2597
2020-09-26;"Bratislavský kraj";86;0;0;0;NA;59578;86;2020-09-26;2549
2020-09-25;"Bratislavský kraj";97;0;0;0;NA;59578;97;2020-09-25;2463
2020-09-24;"Bratislavský kraj";73;0;0;0;NA;59578;73;2020-09-24;2366
2020-09-23;"Bratislavský kraj";55;0;0;0;NA;59578;55;2020-09-23;2293
2020-09-22;"Bratislavský kraj";81;0;0;0;NA;59578;81;2020-09-22;2238
2020-09-21;"Bratislavský kraj";32;0;0;0;NA;59578;32;2020-09-21;2157
2020-09-20;"Bratislavský kraj";25;0;0;0;NA;59578;25;2020-09-20;2125
2020-09-19;"Bratislavský kraj";59;0;0;0;NA;59578;59;2020-09-19;2100
2020-09-18;"Bratislavský kraj";42;0;0;0;NA;59578;42;2020-09-18;2041
2020-09-17;"Bratislavský kraj";52;0;0;0;NA;59578;52;2020-09-17;1999
2020-09-16;"Bratislavský kraj";32;0;0;0;NA;59578;32;2020-09-16;1947
2020-09-15;"Bratislavský kraj";26;0;0;0;NA;59578;26;2020-09-15;1915
2020-09-14;"Bratislavský kraj";24;0;0;0;NA;59578;24;2020-09-14;1889
2020-09-13;"Bratislavský kraj";11;0;0;0;NA;59578;11;2020-09-13;1865
2020-09-12;"Bratislavský kraj";24;0;0;0;NA;59578;24;2020-09-12;1854
2020-09-11;"Bratislavský kraj";50;0;0;0;NA;59578;50;2020-09-11;1830
2020-09-10;"Bratislavský kraj";47;0;0;0;NA;59578;47;2020-09-10;1780
2020-09-09;"Bratislavský kraj";40;0;0;0;NA;59578;40;2020-09-09;1733
2020-09-08;"Bratislavský kraj";58;0;0;0;NA;59578;58;2020-09-08;1693
2020-09-07;"Bratislavský kraj";39;0;0;0;NA;59578;39;2020-09-07;1635
2020-09-06;"Bratislavský kraj";11;0;0;0;NA;59578;11;2020-09-06;1596
2020-09-05;"Bratislavský kraj";37;0;0;0;NA;59578;37;2020-09-05;1585
2020-09-04;"Bratislavský kraj";87;0;0;0;NA;59578;87;2020-09-04;1548
2020-09-03;"Bratislavský kraj";51;0;0;0;NA;59578;51;2020-09-03;1461
2021-02-11;"Košický kraj";435;12574;271;12845;34759;58063;706;2021-02-11;58063
2021-02-10;"Košický kraj";360;19473;430;19903;NA;58063;790;2021-02-10;57357
2021-02-09;"Košický kraj";545;38342;702;39044;NA;58063;1247;2021-02-09;56567
2021-02-08;"Košický kraj";237;26208;392;26600;NA;58063;629;2021-02-08;55320
2021-02-07;"Košický kraj";208;54459;565;55024;NA;58063;773;2021-02-07;54691
2021-02-06;"Košický kraj";318;97223;792;98015;NA;58063;1110;2021-02-06;53918
2021-02-05;"Košický kraj";384;41569;482;42051;NA;58063;866;2021-02-05;52808
2021-02-04;"Košický kraj";391;14314;359;14673;NA;58063;750;2021-02-04;51942
2021-02-03;"Košický kraj";296;32427;1103;33530;NA;58063;1399;2021-02-03;51192
2021-02-02;"Košický kraj";473;25221;486;25707;NA;58063;959;2021-02-02;49793
2021-02-01;"Košický kraj";415;18442;305;18747;NA;58063;720;2021-02-01;48834
2021-01-31;"Košický kraj";142;51037;557;51594;NA;58063;699;2021-01-31;48114
2021-01-30;"Košický kraj";320;73254;614;73868;NA;58063;934;2021-01-30;47415
2021-01-29;"Košický kraj";258;36222;412;36634;NA;58063;670;2021-01-29;46481
2021-01-28;"Košický kraj";540;8833;233;9066;NA;58063;773;2021-01-28;45811
2021-01-27;"Košický kraj";265;7245;195;7440;NA;58063;460;2021-01-27;45038
2021-01-26;"Košický kraj";530;13909;240;14149;NA;58063;770;2021-01-26;44578
2021-01-25;"Košický kraj";226;26799;400;27199;NA;58063;626;2021-01-25;43808
2021-01-24;"Košický kraj";150;42381;561;42942;NA;58063;711;2021-01-24;43182
2021-01-23;"Košický kraj";232;78949;801;79750;NA;58063;1033;2021-01-23;42471
2021-01-22;"Košický kraj";316;19899;241;20140;NA;58063;557;2021-01-22;41438
2021-01-21;"Košický kraj";274;13322;158;13480;NA;58063;432;2021-01-21;40881
2021-01-20;"Košický kraj";374;10566;194;10760;NA;58063;568;2021-01-20;40449
2021-01-19;"Košický kraj";248;9364;177;9541;NA;58063;425;2021-01-19;39881
2021-01-18;"Košický kraj";333;12413;730;13143;NA;58063;1063;2021-01-18;39456
2021-01-17;"Košický kraj";155;535;14;549;NA;58063;169;2021-01-17;38393
2021-01-16;"Košický kraj";153;1551;51;1602;NA;58063;204;2021-01-16;38224
2021-01-15;"Košický kraj";308;6252;212;6464;NA;58063;520;2021-01-15;38020
2021-01-14;"Košický kraj";358;5326;211;5537;NA;58063;569;2021-01-14;37500
2021-01-13;"Košický kraj";421;4753;218;4971;NA;58063;639;2021-01-13;36931
2021-01-12;"Košický kraj";482;6574;247;6821;NA;58063;729;2021-01-12;36292
2021-01-11;"Košický kraj";309;7655;291;7946;NA;58063;600;2021-01-11;35563
2021-01-10;"Košický kraj";193;134;6;140;NA;58063;199;2021-01-10;34963
2021-01-09;"Košický kraj";469;1428;66;1494;NA;58063;535;2021-01-09;34764
2021-01-08;"Košický kraj";551;7861;375;8236;NA;58063;926;2021-01-08;34229
2021-01-07;"Košický kraj";251;5925;385;6310;NA;58063;636;2021-01-07;33303
2021-01-06;"Košický kraj";442;595;50;645;NA;58063;492;2021-01-06;32667
2021-01-05;"Košický kraj";584;7680;521;8201;NA;58063;1105;2021-01-05;32175
2021-01-04;"Košický kraj";407;6567;667;7234;NA;58063;1074;2021-01-04;31070
2021-01-03;"Košický kraj";118;661;22;683;NA;58063;140;2021-01-03;29996
2021-01-02;"Košický kraj";88;440;52;492;NA;58063;140;2021-01-02;29856
2021-01-01;"Košický kraj";398;725;49;774;NA;58063;447;2021-01-01;29716
2020-12-31;"Košický kraj";625;7411;443;7854;NA;58063;1068;2020-12-31;29269
2020-12-30;"Košický kraj";590;6351;402;6753;NA;58063;992;2020-12-30;28201
2020-12-29;"Košický kraj";419;7573;605;8178;NA;58063;1024;2020-12-29;27209
2020-12-28;"Košický kraj";356;8296;804;9100;NA;58063;1160;2020-12-28;26185
2020-12-27;"Košický kraj";159;147;16;163;NA;58063;175;2020-12-27;25025
2020-12-26;"Košický kraj";163;274;23;297;NA;58063;186;2020-12-26;24850
2020-12-25;"Košický kraj";237;140;10;150;NA;58063;247;2020-12-25;24664
2020-12-24;"Košický kraj";564;1470;90;1560;NA;58063;654;2020-12-24;24417
2020-12-23;"Košický kraj";304;7942;354;8296;NA;58063;658;2020-12-23;23763
2020-12-22;"Košický kraj";438;7920;459;8379;NA;58063;897;2020-12-22;23105
2020-12-21;"Košický kraj";405;6984;509;7493;NA;58063;914;2020-12-21;22208
2020-12-20;"Košický kraj";215;48;8;56;NA;58063;223;2020-12-20;21294
2020-12-19;"Košický kraj";207;1148;59;1207;NA;58063;266;2020-12-19;21071
2020-12-18;"Košický kraj";310;8484;326;8810;NA;58063;636;2020-12-18;20805
2020-12-17;"Košický kraj";463;5292;255;5547;NA;58063;718;2020-12-17;20169
2020-12-16;"Košický kraj";455;5632;582;6214;NA;58063;1037;2020-12-16;19451
2020-12-15;"Košický kraj";319;5086;338;5424;NA;58063;657;2020-12-15;18414
2020-12-14;"Košický kraj";256;2893;239;3132;NA;58063;495;2020-12-14;17757
2020-12-13;"Košický kraj";47;181;2;183;NA;58063;49;2020-12-13;17262
2020-12-12;"Košický kraj";369;1587;118;1705;NA;58063;487;2020-12-12;17213
2020-12-11;"Košický kraj";355;5461;258;5719;NA;58063;613;2020-12-11;16726
2020-12-10;"Košický kraj";283;4064;176;4240;NA;58063;459;2020-12-10;16113
2020-12-09;"Košický kraj";279;3786;166;3952;NA;58063;445;2020-12-09;15654
2020-12-08;"Košický kraj";226;4105;355;4460;NA;58063;581;2020-12-08;15209
2020-12-07;"Košický kraj";270;2111;103;2214;NA;58063;373;2020-12-07;14628
2020-12-06;"Košický kraj";121;97;20;117;NA;58063;141;2020-12-06;14255
2020-12-05;"Košický kraj";90;1096;48;1144;NA;58063;138;2020-12-05;14114
2020-12-04;"Košický kraj";224;2680;82;2762;NA;58063;306;2020-12-04;13976
2020-12-03;"Košický kraj";211;7717;173;7890;NA;58063;384;2020-12-03;13670
2020-12-02;"Košický kraj";194;3654;124;3778;NA;58063;318;2020-12-02;13286
2020-12-01;"Košický kraj";178;2237;124;2361;NA;58063;302;2020-12-01;12968
2020-11-30;"Košický kraj";171;3754;62;3816;NA;58063;233;2020-11-30;12666
2020-11-29;"Košický kraj";31;287;16;303;NA;58063;47;2020-11-29;12433
2020-11-28;"Košický kraj";69;721;52;773;NA;58063;121;2020-11-28;12386
2020-11-27;"Košický kraj";149;2729;74;2803;NA;58063;223;2020-11-27;12265
2020-11-26;"Košický kraj";239;1090;55;1145;NA;58063;294;2020-11-26;12042
2020-11-25;"Košický kraj";237;1664;122;1786;NA;58063;359;2020-11-25;11748
2020-11-24;"Košický kraj";196;1871;64;1935;NA;58063;260;2020-11-24;11389
2020-11-23;"Košický kraj";51;3737;54;3791;NA;58063;105;2020-11-23;11129
2020-11-22;"Košický kraj";57;28;3;31;NA;58063;60;2020-11-22;11024
2020-11-21;"Košický kraj";87;858;36;894;NA;58063;123;2020-11-21;10964
2020-11-20;"Košický kraj";176;2989;45;3034;NA;58063;221;2020-11-20;10841
2020-11-19;"Košický kraj";206;1648;40;1688;NA;58063;246;2020-11-19;10620
2020-11-18;"Košický kraj";122;443;16;459;NA;58063;138;2020-11-18;10374
2020-11-17;"Košický kraj";152;82;9;91;NA;58063;161;2020-11-17;10236
2020-11-16;"Košický kraj";114;531;24;555;NA;58063;138;2020-11-16;10075
2020-11-15;"Košický kraj";15;338;7;345;NA;58063;22;2020-11-15;9937
2020-11-14;"Košický kraj";234;520;12;532;NA;58063;246;2020-11-14;9915
2020-11-13;"Košický kraj";207;664;29;693;NA;58063;236;2020-11-13;9669
2020-11-12;"Košický kraj";192;736;13;749;NA;58063;205;2020-11-12;9433
2020-11-11;"Košický kraj";301;593;7;600;NA;58063;308;2020-11-11;9228
2020-11-10;"Košický kraj";190;541;11;552;NA;58063;201;2020-11-10;8920
2020-11-09;"Košický kraj";129;380;5;385;NA;58063;134;2020-11-09;8719
2020-11-08;"Košický kraj";78;1298;8;1306;NA;58063;86;2020-11-08;8585
2020-11-07;"Košický kraj";192;3909;22;3931;NA;58063;214;2020-11-07;8499
2020-11-06;"Košický kraj";195;5310;34;5344;NA;58063;229;2020-11-06;8285
2020-11-05;"Košický kraj";342;330;31;361;NA;58063;373;2020-11-05;8056
2020-11-04;"Košický kraj";101;154;6;160;NA;58063;107;2020-11-04;7683
2020-11-03;"Košický kraj";358;1122;13;1135;NA;58063;371;2020-11-03;7576
2020-11-02;"Košický kraj";111;4368;51;4419;NA;58063;162;2020-11-02;7205
2020-11-01;"Košický kraj";346;6522;34;6556;NA;58063;380;2020-11-01;7043
2020-10-31;"Košický kraj";82;13810;105;13915;NA;58063;187;2020-10-31;6663
2020-10-30;"Košický kraj";379;2835;27;2862;NA;58063;406;2020-10-30;6476
2020-10-29;"Košický kraj";333;983;13;996;NA;58063;346;2020-10-29;6070
2020-10-28;"Košický kraj";224;305;13;318;NA;58063;237;2020-10-28;5724
2020-10-27;"Košický kraj";386;439;21;460;NA;58063;407;2020-10-27;5487
2020-10-26;"Košický kraj";56;206;10;216;NA;58063;66;2020-10-26;5080
2020-10-25;"Košický kraj";154;79;2;81;NA;58063;156;2020-10-25;5014
2020-10-24;"Košický kraj";313;113;15;128;NA;58063;328;2020-10-24;4858
2020-10-23;"Košický kraj";315;331;8;339;NA;58063;323;2020-10-23;4530
2020-10-22;"Košický kraj";349;530;16;546;NA;58063;365;2020-10-22;4207
2020-10-21;"Košický kraj";129;84;2;86;NA;58063;131;2020-10-21;3842
2020-10-20;"Košický kraj";181;14;1;15;NA;58063;182;2020-10-20;3711
2020-10-19;"Košický kraj";64;10;0;10;NA;58063;64;2020-10-19;3529
2020-10-18;"Košický kraj";158;0;0;0;NA;58063;158;2020-10-18;3465
2020-10-17;"Košický kraj";142;0;0;0;NA;58063;142;2020-10-17;3307
2020-10-16;"Košický kraj";206;19;0;19;NA;58063;206;2020-10-16;3165
2020-10-15;"Košický kraj";177;19;5;24;NA;58063;182;2020-10-15;2959
2020-10-14;"Košický kraj";211;8;0;8;NA;58063;211;2020-10-14;2777
2020-10-13;"Košický kraj";179;80;3;83;NA;58063;182;2020-10-13;2566
2020-10-12;"Košický kraj";74;0;0;0;NA;58063;74;2020-10-12;2384
2020-10-11;"Košický kraj";121;0;0;0;NA;58063;121;2020-10-11;2310
2020-10-10;"Košický kraj";70;0;0;0;NA;58063;70;2020-10-10;2189
2020-10-09;"Košický kraj";188;0;0;0;NA;58063;188;2020-10-09;2119
2020-10-08;"Košický kraj";102;0;0;0;NA;58063;102;2020-10-08;1931
2020-10-07;"Košický kraj";158;0;0;0;NA;58063;158;2020-10-07;1829
2020-10-06;"Košický kraj";70;0;0;0;NA;58063;70;2020-10-06;1671
2020-10-05;"Košický kraj";39;0;0;0;NA;58063;39;2020-10-05;1601
2020-10-04;"Košický kraj";45;0;0;0;NA;58063;45;2020-10-04;1562
2020-10-03;"Košický kraj";105;0;0;0;NA;58063;105;2020-10-03;1517
2020-10-02;"Košický kraj";57;0;0;0;NA;58063;57;2020-10-02;1412
2020-10-01;"Košický kraj";69;0;0;0;NA;58063;69;2020-10-01;1355
2020-09-30;"Košický kraj";95;0;0;0;NA;58063;95;2020-09-30;1286
2020-09-29;"Košický kraj";75;0;0;0;NA;58063;75;2020-09-29;1191
2020-09-28;"Košický kraj";19;0;0;0;NA;58063;19;2020-09-28;1116
2020-09-27;"Košický kraj";21;0;0;0;NA;58063;21;2020-09-27;1097
2020-09-26;"Košický kraj";53;0;0;0;NA;58063;53;2020-09-26;1076
2020-09-25;"Košický kraj";72;0;0;0;NA;58063;72;2020-09-25;1023
2020-09-24;"Košický kraj";35;0;0;0;NA;58063;35;2020-09-24;951
2020-09-23;"Košický kraj";23;0;0;0;NA;58063;23;2020-09-23;916
2020-09-22;"Košický kraj";39;0;0;0;NA;58063;39;2020-09-22;893
2020-09-21;"Košický kraj";5;0;0;0;NA;58063;5;2020-09-21;854
2020-09-20;"Košický kraj";3;0;0;0;NA;58063;3;2020-09-20;849
2020-09-19;"Košický kraj";13;0;0;0;NA;58063;13;2020-09-19;846
2020-09-18;"Košický kraj";20;0;0;0;NA;58063;20;2020-09-18;833
2020-09-17;"Košický kraj";22;0;0;0;NA;58063;22;2020-09-17;813
2020-09-16;"Košický kraj";12;0;0;0;NA;58063;12;2020-09-16;791
2020-09-15;"Košický kraj";10;0;0;0;NA;58063;10;2020-09-15;779
2020-09-14;"Košický kraj";6;0;0;0;NA;58063;6;2020-09-14;769
2020-09-13;"Košický kraj";3;0;0;0;NA;58063;3;2020-09-13;763
2020-09-12;"Košický kraj";16;0;0;0;NA;58063;16;2020-09-12;760
2020-09-11;"Košický kraj";20;0;0;0;NA;58063;20;2020-09-11;744
2020-09-10;"Košický kraj";11;0;0;0;NA;58063;11;2020-09-10;724
2020-09-09;"Košický kraj";37;0;0;0;NA;58063;37;2020-09-09;713
2020-09-08;"Košický kraj";10;0;0;0;NA;58063;10;2020-09-08;676
2020-09-07;"Košický kraj";4;0;0;0;NA;58063;4;2020-09-07;666
2020-09-06;"Košický kraj";2;0;0;0;NA;58063;2;2020-09-06;662
2020-09-05;"Košický kraj";10;0;0;0;NA;58063;10;2020-09-05;660
2020-09-04;"Košický kraj";14;0;0;0;NA;58063;14;2020-09-04;650
2020-09-03;"Košický kraj";22;0;0;0;NA;58063;22;2020-09-03;636
2021-02-11;"Nitriansky kraj";195;9508;205;9713;31645;70266;400;2021-02-11;70266
2021-02-10;"Nitriansky kraj";186;17124;629;17753;NA;70266;815;2021-02-10;69866
2021-02-09;"Nitriansky kraj";260;18830;389;19219;NA;70266;649;2021-02-09;69051
2021-02-08;"Nitriansky kraj";177;43712;668;44380;NA;70266;845;2021-02-08;68402
2021-02-07;"Nitriansky kraj";20;46699;442;47141;NA;70266;462;2021-02-07;67557
2021-02-06;"Nitriansky kraj";129;88915;802;89717;NA;70266;931;2021-02-06;67095
2021-02-05;"Nitriansky kraj";244;36189;662;36851;NA;70266;906;2021-02-05;66164
2021-02-04;"Nitriansky kraj";308;15512;491;16003;NA;70266;799;2021-02-04;65258
2021-02-03;"Nitriansky kraj";191;10635;330;10965;NA;70266;521;2021-02-03;64459
2021-02-02;"Nitriansky kraj";327;17021;360;17381;NA;70266;687;2021-02-02;63938
2021-02-01;"Nitriansky kraj";221;24117;444;24561;NA;70266;665;2021-02-01;63251
2021-01-31;"Nitriansky kraj";9;19045;199;19244;NA;70266;208;2021-01-31;62586
2021-01-30;"Nitriansky kraj";152;72176;683;72859;NA;70266;835;2021-01-30;62378
2021-01-29;"Nitriansky kraj";135;23358;469;23827;NA;70266;604;2021-01-29;61543
2021-01-28;"Nitriansky kraj";269;10881;368;11249;NA;70266;637;2021-01-28;60939
2021-01-27;"Nitriansky kraj";235;13256;377;13633;NA;70266;612;2021-01-27;60302
2021-01-26;"Nitriansky kraj";345;17005;453;17458;NA;70266;798;2021-01-26;59690
2021-01-25;"Nitriansky kraj";201;23502;442;23944;NA;70266;643;2021-01-25;58892
2021-01-24;"Nitriansky kraj";12;61563;583;62146;NA;70266;595;2021-01-24;58249
2021-01-23;"Nitriansky kraj";277;99700;1489;101189;NA;70266;1766;2021-01-23;57654
2021-01-22;"Nitriansky kraj";139;34070;586;34656;NA;70266;725;2021-01-22;55888
2021-01-21;"Nitriansky kraj";305;14309;406;14715;NA;70266;711;2021-01-21;55163
2021-01-20;"Nitriansky kraj";326;11510;612;12122;NA;70266;938;2021-01-20;54452
2021-01-19;"Nitriansky kraj";344;10778;623;11401;NA;70266;967;2021-01-19;53514
2021-01-18;"Nitriansky kraj";367;8479;494;8973;NA;70266;861;2021-01-18;52547
2021-01-17;"Nitriansky kraj";97;15061;275;15336;NA;70266;372;2021-01-17;51686
2021-01-16;"Nitriansky kraj";64;35485;645;36130;NA;70266;709;2021-01-16;51314
2021-01-15;"Nitriansky kraj";373;15947;479;16426;NA;70266;852;2021-01-15;50605
2021-01-14;"Nitriansky kraj";627;10268;440;10708;NA;70266;1067;2021-01-14;49753
2021-01-13;"Nitriansky kraj";663;9167;497;9664;NA;70266;1160;2021-01-13;48686
2021-01-12;"Nitriansky kraj";642;8992;574;9566;NA;70266;1216;2021-01-12;47526
2021-01-11;"Nitriansky kraj";422;8175;515;8690;NA;70266;937;2021-01-11;46310
2021-01-10;"Nitriansky kraj";44;18767;703;19470;NA;70266;747;2021-01-10;45373
2021-01-09;"Nitriansky kraj";532;37075;1090;38165;NA;70266;1622;2021-01-09;44626
2021-01-08;"Nitriansky kraj";817;14004;719;14723;NA;70266;1536;2021-01-08;43004
2021-01-07;"Nitriansky kraj";438;10465;784;11249;NA;70266;1222;2021-01-07;41468
2021-01-06;"Nitriansky kraj";259;3347;239;3586;NA;70266;498;2021-01-06;40246
2021-01-05;"Nitriansky kraj";732;8815;1204;10019;NA;70266;1936;2021-01-05;39748
2021-01-04;"Nitriansky kraj";362;8247;1270;9517;NA;70266;1632;2021-01-04;37812
2021-01-03;"Nitriansky kraj";42;84;20;104;NA;70266;62;2021-01-03;36180
2021-01-02;"Nitriansky kraj";249;1090;26;1116;NA;70266;275;2021-01-02;36118
2021-01-01;"Nitriansky kraj";119;671;94;765;NA;70266;213;2021-01-01;35843
2020-12-31;"Nitriansky kraj";786;6079;693;6772;NA;70266;1479;2020-12-31;35630
2020-12-30;"Nitriansky kraj";1094;8641;1098;9739;NA;70266;2192;2020-12-30;34151
2020-12-29;"Nitriansky kraj";607;7870;1245;9115;NA;70266;1852;2020-12-29;31959
2020-12-28;"Nitriansky kraj";83;6881;1271;8152;NA;70266;1354;2020-12-28;30107
2020-12-27;"Nitriansky kraj";22;36;2;38;NA;70266;24;2020-12-27;28753
2020-12-26;"Nitriansky kraj";54;297;56;353;NA;70266;110;2020-12-26;28729
2020-12-25;"Nitriansky kraj";35;47;5;52;NA;70266;40;2020-12-25;28619
2020-12-24;"Nitriansky kraj";514;1861;176;2037;NA;70266;690;2020-12-24;28579
2020-12-23;"Nitriansky kraj";349;15214;843;16057;NA;70266;1192;2020-12-23;27889
2020-12-22;"Nitriansky kraj";673;10915;994;11909;NA;70266;1667;2020-12-22;26697
2020-12-21;"Nitriansky kraj";128;7719;976;8695;NA;70266;1104;2020-12-21;25030
2020-12-20;"Nitriansky kraj";77;50;10;60;NA;70266;87;2020-12-20;23926
2020-12-19;"Nitriansky kraj";262;2449;169;2618;NA;70266;431;2020-12-19;23839
2020-12-18;"Nitriansky kraj";512;8130;541;8671;NA;70266;1053;2020-12-18;23408
2020-12-17;"Nitriansky kraj";586;6705;514;7219;NA;70266;1100;2020-12-17;22355
2020-12-16;"Nitriansky kraj";357;8265;513;8778;NA;70266;870;2020-12-16;21255
2020-12-15;"Nitriansky kraj";461;9365;769;10134;NA;70266;1230;2020-12-15;20385
2020-12-14;"Nitriansky kraj";217;8089;827;8916;NA;70266;1044;2020-12-14;19155
2020-12-13;"Nitriansky kraj";12;9;1;10;NA;70266;13;2020-12-13;18111
2020-12-12;"Nitriansky kraj";341;1832;125;1957;NA;70266;466;2020-12-12;18098
2020-12-11;"Nitriansky kraj";409;5976;454;6430;NA;70266;863;2020-12-11;17632
2020-12-10;"Nitriansky kraj";360;5030;326;5356;NA;70266;686;2020-12-10;16769
2020-12-09;"Nitriansky kraj";362;5726;542;6268;NA;70266;904;2020-12-09;16083
2020-12-08;"Nitriansky kraj";340;8766;611;9377;NA;70266;951;2020-12-08;15179
2020-12-07;"Nitriansky kraj";139;6243;573;6816;NA;70266;712;2020-12-07;14228
2020-12-06;"Nitriansky kraj";15;89;4;93;NA;70266;19;2020-12-06;13516
2020-12-05;"Nitriansky kraj";136;618;14;632;NA;70266;150;2020-12-05;13497
2020-12-04;"Nitriansky kraj";232;3047;86;3133;NA;70266;318;2020-12-04;13347
2020-12-03;"Nitriansky kraj";248;2599;127;2726;NA;70266;375;2020-12-03;13029
2020-12-02;"Nitriansky kraj";252;3733;163;3896;NA;70266;415;2020-12-02;12654
2020-12-01;"Nitriansky kraj";331;2940;134;3074;NA;70266;465;2020-12-01;12239
2020-11-30;"Nitriansky kraj";91;4232;143;4375;NA;70266;234;2020-11-30;11774
2020-11-29;"Nitriansky kraj";3;620;42;662;NA;70266;45;2020-11-29;11540
2020-11-28;"Nitriansky kraj";135;892;31;923;NA;70266;166;2020-11-28;11495
2020-11-27;"Nitriansky kraj";177;1229;43;1272;NA;70266;220;2020-11-27;11329
2020-11-26;"Nitriansky kraj";191;2262;57;2319;NA;70266;248;2020-11-26;11109
2020-11-25;"Nitriansky kraj";325;1993;66;2059;NA;70266;391;2020-11-25;10861
2020-11-24;"Nitriansky kraj";147;1141;50;1191;NA;70266;197;2020-11-24;10470
2020-11-23;"Nitriansky kraj";102;9562;206;9768;NA;70266;308;2020-11-23;10273
2020-11-22;"Nitriansky kraj";7;0;0;0;NA;70266;7;2020-11-22;9965
2020-11-21;"Nitriansky kraj";86;1083;38;1121;NA;70266;124;2020-11-21;9958
2020-11-20;"Nitriansky kraj";264;4020;101;4121;NA;70266;365;2020-11-20;9834
2020-11-19;"Nitriansky kraj";185;2953;133;3086;NA;70266;318;2020-11-19;9469
2020-11-18;"Nitriansky kraj";188;2109;77;2186;NA;70266;265;2020-11-18;9151
2020-11-17;"Nitriansky kraj";178;596;29;625;NA;70266;207;2020-11-17;8886
2020-11-16;"Nitriansky kraj";139;1836;75;1911;NA;70266;214;2020-11-16;8679
2020-11-15;"Nitriansky kraj";14;10;1;11;NA;70266;15;2020-11-15;8465
2020-11-14;"Nitriansky kraj";114;1131;32;1163;NA;70266;146;2020-11-14;8450
2020-11-13;"Nitriansky kraj";210;936;46;982;NA;70266;256;2020-11-13;8304
2020-11-12;"Nitriansky kraj";256;1195;35;1230;NA;70266;291;2020-11-12;8048
2020-11-11;"Nitriansky kraj";279;1247;22;1269;NA;70266;301;2020-11-11;7757
2020-11-10;"Nitriansky kraj";192;2623;39;2662;NA;70266;231;2020-11-10;7456
2020-11-09;"Nitriansky kraj";128;3136;43;3179;NA;70266;171;2020-11-09;7225
2020-11-08;"Nitriansky kraj";43;1462;32;1494;NA;70266;75;2020-11-08;7054
2020-11-07;"Nitriansky kraj";130;1046;4;1050;NA;70266;134;2020-11-07;6979
2020-11-06;"Nitriansky kraj";210;2264;32;2296;NA;70266;242;2020-11-06;6845
2020-11-05;"Nitriansky kraj";178;312;14;326;NA;70266;192;2020-11-05;6603
2020-11-04;"Nitriansky kraj";211;297;16;313;NA;70266;227;2020-11-04;6411
2020-11-03;"Nitriansky kraj";216;435;25;460;NA;70266;241;2020-11-03;6184
2020-11-02;"Nitriansky kraj";171;4208;46;4254;NA;70266;217;2020-11-02;5943
2020-11-01;"Nitriansky kraj";130;2546;27;2573;NA;70266;157;2020-11-01;5726
2020-10-31;"Nitriansky kraj";261;10466;134;10600;NA;70266;395;2020-10-31;5569
2020-10-30;"Nitriansky kraj";204;2380;21;2401;NA;70266;225;2020-10-30;5174
2020-10-29;"Nitriansky kraj";293;841;39;880;NA;70266;332;2020-10-29;4949
2020-10-28;"Nitriansky kraj";216;608;59;667;NA;70266;275;2020-10-28;4617
2020-10-27;"Nitriansky kraj";296;550;47;597;NA;70266;343;2020-10-27;4342
2020-10-26;"Nitriansky kraj";69;633;56;689;NA;70266;125;2020-10-26;3999
2020-10-25;"Nitriansky kraj";50;40;6;46;NA;70266;56;2020-10-25;3874
2020-10-24;"Nitriansky kraj";169;237;11;248;NA;70266;180;2020-10-24;3818
2020-10-23;"Nitriansky kraj";282;762;41;803;NA;70266;323;2020-10-23;3638
2020-10-22;"Nitriansky kraj";137;444;39;483;NA;70266;176;2020-10-22;3315
2020-10-21;"Nitriansky kraj";146;208;3;211;NA;70266;149;2020-10-21;3139
2020-10-20;"Nitriansky kraj";197;78;6;84;NA;70266;203;2020-10-20;2990
2020-10-19;"Nitriansky kraj";148;79;1;80;NA;70266;149;2020-10-19;2787
2020-10-18;"Nitriansky kraj";22;0;0;0;NA;70266;22;2020-10-18;2638
2020-10-17;"Nitriansky kraj";67;0;0;0;NA;70266;67;2020-10-17;2616
2020-10-16;"Nitriansky kraj";133;28;3;31;NA;70266;136;2020-10-16;2549
2020-10-15;"Nitriansky kraj";106;31;2;33;NA;70266;108;2020-10-15;2413
2020-10-14;"Nitriansky kraj";80;22;4;26;NA;70266;84;2020-10-14;2305
2020-10-13;"Nitriansky kraj";101;82;2;84;NA;70266;103;2020-10-13;2221
2020-10-12;"Nitriansky kraj";36;0;0;0;NA;70266;36;2020-10-12;2118
2020-10-11;"Nitriansky kraj";8;0;0;0;NA;70266;8;2020-10-11;2082
2020-10-10;"Nitriansky kraj";107;0;0;0;NA;70266;107;2020-10-10;2074
2020-10-09;"Nitriansky kraj";120;0;0;0;NA;70266;120;2020-10-09;1967
2020-10-08;"Nitriansky kraj";132;0;0;0;NA;70266;132;2020-10-08;1847
2020-10-07;"Nitriansky kraj";81;0;0;0;NA;70266;81;2020-10-07;1715
2020-10-06;"Nitriansky kraj";48;0;0;0;NA;70266;48;2020-10-06;1634
2020-10-05;"Nitriansky kraj";20;0;0;0;NA;70266;20;2020-10-05;1586
2020-10-04;"Nitriansky kraj";17;0;0;0;NA;70266;17;2020-10-04;1566
2020-10-03;"Nitriansky kraj";96;0;0;0;NA;70266;96;2020-10-03;1549
2020-10-02;"Nitriansky kraj";108;0;0;0;NA;70266;108;2020-10-02;1453
2020-10-01;"Nitriansky kraj";95;0;0;0;NA;70266;95;2020-10-01;1345
2020-09-30;"Nitriansky kraj";100;0;0;0;NA;70266;100;2020-09-30;1250
2020-09-29;"Nitriansky kraj";50;0;0;0;NA;70266;50;2020-09-29;1150
2020-09-28;"Nitriansky kraj";22;0;0;0;NA;70266;22;2020-09-28;1100
2020-09-27;"Nitriansky kraj";16;0;0;0;NA;70266;16;2020-09-27;1078
2020-09-26;"Nitriansky kraj";64;0;0;0;NA;70266;64;2020-09-26;1062
2020-09-25;"Nitriansky kraj";90;0;0;0;NA;70266;90;2020-09-25;998
2020-09-24;"Nitriansky kraj";51;0;0;0;NA;70266;51;2020-09-24;908
2020-09-23;"Nitriansky kraj";70;0;0;0;NA;70266;70;2020-09-23;857
2020-09-22;"Nitriansky kraj";18;0;0;0;NA;70266;18;2020-09-22;787
2020-09-21;"Nitriansky kraj";10;0;0;0;NA;70266;10;2020-09-21;769
2020-09-20;"Nitriansky kraj";4;0;0;0;NA;70266;4;2020-09-20;759
2020-09-19;"Nitriansky kraj";14;0;0;0;NA;70266;14;2020-09-19;755
2020-09-18;"Nitriansky kraj";19;0;0;0;NA;70266;19;2020-09-18;741
2020-09-17;"Nitriansky kraj";30;0;0;0;NA;70266;30;2020-09-17;722
2020-09-16;"Nitriansky kraj";6;0;0;0;NA;70266;6;2020-09-16;692
2020-09-15;"Nitriansky kraj";19;0;0;0;NA;70266;19;2020-09-15;686
2020-09-14;"Nitriansky kraj";28;0;0;0;NA;70266;28;2020-09-14;667
2020-09-13;"Nitriansky kraj";3;0;0;0;NA;70266;3;2020-09-13;639
2020-09-12;"Nitriansky kraj";12;0;0;0;NA;70266;12;2020-09-12;636
2020-09-11;"Nitriansky kraj";23;0;0;0;NA;70266;23;2020-09-11;624
2020-09-10;"Nitriansky kraj";29;0;0;0;NA;70266;29;2020-09-10;601
2020-09-09;"Nitriansky kraj";19;0;0;0;NA;70266;19;2020-09-09;572
2020-09-08;"Nitriansky kraj";17;0;0;0;NA;70266;17;2020-09-08;553
2020-09-07;"Nitriansky kraj";17;0;0;0;NA;70266;17;2020-09-07;536
2020-09-05;"Nitriansky kraj";22;0;0;0;NA;70266;22;2020-09-05;519
2020-09-04;"Nitriansky kraj";34;0;0;0;NA;70266;34;2020-09-04;497
2020-09-03;"Nitriansky kraj";15;0;0;0;NA;70266;15;2020-09-03;463
2021-02-11;"Prešovský kraj";218;11750;181;11931;40780;70062;399;2021-02-11;70062
2021-02-10;"Prešovský kraj";220;16647;257;16904;NA;70062;477;2021-02-10;69663
2021-02-09;"Prešovský kraj";323;18696;320;19016;NA;70062;643;2021-02-09;69186
2021-02-08;"Prešovský kraj";161;36283;234;36517;NA;70062;395;2021-02-08;68543
2021-02-07;"Prešovský kraj";21;21981;150;22131;NA;70062;171;2021-02-07;68148
2021-02-06;"Prešovský kraj";176;65626;347;65973;NA;70062;523;2021-02-06;67977
2021-02-05;"Prešovský kraj";177;27311;238;27549;NA;70062;415;2021-02-05;67454
2021-02-04;"Prešovský kraj";176;11939;218;12157;NA;70062;394;2021-02-04;67039
2021-02-03;"Prešovský kraj";251;7462;200;7662;NA;70062;451;2021-02-03;66645
2021-02-02;"Prešovský kraj";249;11504;274;11778;NA;70062;523;2021-02-02;66194
2021-02-01;"Prešovský kraj";220;15195;271;15466;NA;70062;491;2021-02-01;65671
2021-01-31;"Prešovský kraj";42;1623;38;1661;NA;70062;80;2021-01-31;65180
2021-01-30;"Prešovský kraj";142;23543;212;23755;NA;70062;354;2021-01-30;65100
2021-01-29;"Prešovský kraj";88;15544;266;15810;NA;70062;354;2021-01-29;64746
2021-01-28;"Prešovský kraj";311;8207;137;8344;NA;70062;448;2021-01-28;64392
2021-01-27;"Prešovský kraj";153;9144;134;9278;NA;70062;287;2021-01-27;63944
2021-01-26;"Prešovský kraj";252;15960;141;16101;NA;70062;393;2021-01-26;63657
2021-01-25;"Prešovský kraj";196;27636;236;27872;NA;70062;432;2021-01-25;63264
2021-01-24;"Prešovský kraj";12;52958;386;53344;NA;70062;398;2021-01-24;62832
2021-01-23;"Prešovský kraj";189;88850;431;89281;NA;70062;620;2021-01-23;62434
2021-01-22;"Prešovský kraj";187;32850;246;33096;NA;70062;433;2021-01-22;61814
2021-01-21;"Prešovský kraj";187;18674;195;18869;NA;70062;382;2021-01-21;61381
2021-01-20;"Prešovský kraj";253;13031;169;13200;NA;70062;422;2021-01-20;60999
2021-01-19;"Prešovský kraj";281;11004;290;11294;NA;70062;571;2021-01-19;60577
2021-01-18;"Prešovský kraj";203;9455;309;9764;NA;70062;512;2021-01-18;60006
2021-01-17;"Prešovský kraj";107;14393;1008;15401;NA;70062;1115;2021-01-17;59494
2021-01-16;"Prešovský kraj";72;1583;76;1659;NA;70062;148;2021-01-16;58379
2021-01-15;"Prešovský kraj";159;6322;209;6531;NA;70062;368;2021-01-15;58231
2021-01-14;"Prešovský kraj";268;5250;238;5488;NA;70062;506;2021-01-14;57863
2021-01-13;"Prešovský kraj";342;5294;208;5502;NA;70062;550;2021-01-13;57357
2021-01-12;"Prešovský kraj";455;8099;370;8469;NA;70062;825;2021-01-12;56807
2021-01-11;"Prešovský kraj";343;7208;435;7643;NA;70062;778;2021-01-11;55982
2021-01-10;"Prešovský kraj";63;476;23;499;NA;70062;86;2021-01-10;55204
2021-01-09;"Prešovský kraj";439;2248;125;2373;NA;70062;564;2021-01-09;55118
2021-01-08;"Prešovský kraj";430;10059;517;10576;NA;70062;947;2021-01-08;54554
2021-01-07;"Prešovský kraj";268;7387;621;8008;NA;70062;889;2021-01-07;53607
2021-01-06;"Prešovský kraj";315;1259;101;1360;NA;70062;416;2021-01-06;52718
2021-01-05;"Prešovský kraj";655;11094;947;12041;NA;70062;1602;2021-01-05;52302
2021-01-04;"Prešovský kraj";371;16400;1688;18088;NA;70062;2059;2021-01-04;50700
2021-01-03;"Prešovský kraj";89;257;37;294;NA;70062;126;2021-01-03;48641
2021-01-02;"Prešovský kraj";65;1559;160;1719;NA;70062;225;2021-01-02;48515
2021-01-01;"Prešovský kraj";174;914;70;984;NA;70062;244;2021-01-01;48290
2020-12-31;"Prešovský kraj";640;11208;695;11903;NA;70062;1335;2020-12-31;48046
2020-12-30;"Prešovský kraj";729;8300;715;9015;NA;70062;1444;2020-12-30;46711
2020-12-29;"Prešovský kraj";435;8286;863;9149;NA;70062;1298;2020-12-29;45267
2020-12-28;"Prešovský kraj";393;8292;1020;9312;NA;70062;1413;2020-12-28;43969
2020-12-27;"Prešovský kraj";40;571;39;610;NA;70062;79;2020-12-27;42556
2020-12-26;"Prešovský kraj";64;176;12;188;NA;70062;76;2020-12-26;42477
2020-12-25;"Prešovský kraj";208;273;13;286;NA;70062;221;2020-12-25;42401
2020-12-24;"Prešovský kraj";452;1214;85;1299;NA;70062;537;2020-12-24;42180
2020-12-23;"Prešovský kraj";361;10229;781;11010;NA;70062;1142;2020-12-23;41643
2020-12-22;"Prešovský kraj";439;8805;666;9471;NA;70062;1105;2020-12-22;40501
2020-12-21;"Prešovský kraj";432;9396;820;10216;NA;70062;1252;2020-12-21;39396
2020-12-20;"Prešovský kraj";184;396;20;416;NA;70062;204;2020-12-20;38144
2020-12-19;"Prešovský kraj";276;1658;151;1809;NA;70062;427;2020-12-19;37940
2020-12-18;"Prešovský kraj";396;8850;599;9449;NA;70062;995;2020-12-18;37513
2020-12-17;"Prešovský kraj";427;10826;891;11717;NA;70062;1318;2020-12-17;36518
2020-12-16;"Prešovský kraj";466;6017;508;6525;NA;70062;974;2020-12-16;35200
2020-12-15;"Prešovský kraj";411;5685;584;6269;NA;70062;995;2020-12-15;34226
2020-12-14;"Prešovský kraj";334;5767;508;6275;NA;70062;842;2020-12-14;33231
2020-12-13;"Prešovský kraj";89;29;8;37;NA;70062;97;2020-12-13;32389
2020-12-12;"Prešovský kraj";319;2474;166;2640;NA;70062;485;2020-12-12;32292
2020-12-11;"Prešovský kraj";560;6042;418;6460;NA;70062;978;2020-12-11;31807
2020-12-10;"Prešovský kraj";337;5180;440;5620;NA;70062;777;2020-12-10;30829
2020-12-09;"Prešovský kraj";358;3646;270;3916;NA;70062;628;2020-12-09;30052
2020-12-08;"Prešovský kraj";350;6436;647;7083;NA;70062;997;2020-12-08;29424
2020-12-07;"Prešovský kraj";309;3644;337;3981;NA;70062;646;2020-12-07;28427
2020-12-06;"Prešovský kraj";59;358;26;384;NA;70062;85;2020-12-06;27781
2020-12-05;"Prešovský kraj";218;984;87;1071;NA;70062;305;2020-12-05;27696
2020-12-04;"Prešovský kraj";352;4471;281;4752;NA;70062;633;2020-12-04;27391
2020-12-03;"Prešovský kraj";284;2900;202;3102;NA;70062;486;2020-12-03;26758
2020-12-02;"Prešovský kraj";232;3361;235;3596;NA;70062;467;2020-12-02;26272
2020-12-01;"Prešovský kraj";281;2341;213;2554;NA;70062;494;2020-12-01;25805
2020-11-30;"Prešovský kraj";196;5821;110;5931;NA;70062;306;2020-11-30;25311
2020-11-29;"Prešovský kraj";27;379;42;421;NA;70062;69;2020-11-29;25005
2020-11-28;"Prešovský kraj";199;682;62;744;NA;70062;261;2020-11-28;24936
2020-11-27;"Prešovský kraj";232;2135;119;2254;NA;70062;351;2020-11-27;24675
2020-11-26;"Prešovský kraj";263;2787;312;3099;NA;70062;575;2020-11-26;24324
2020-11-25;"Prešovský kraj";302;1642;78;1720;NA;70062;380;2020-11-25;23749
2020-11-24;"Prešovský kraj";365;1662;140;1802;NA;70062;505;2020-11-24;23369
2020-11-23;"Prešovský kraj";164;842;42;884;NA;70062;206;2020-11-23;22864
2020-11-22;"Prešovský kraj";46;30;1;31;NA;70062;47;2020-11-22;22658
2020-11-21;"Prešovský kraj";205;689;57;746;NA;70062;262;2020-11-21;22611
2020-11-20;"Prešovský kraj";363;2063;98;2161;NA;70062;461;2020-11-20;22349
2020-11-19;"Prešovský kraj";359;1973;229;2202;NA;70062;588;2020-11-19;21888
2020-11-18;"Prešovský kraj";270;373;32;405;NA;70062;302;2020-11-18;21300
2020-11-17;"Prešovský kraj";347;151;17;168;NA;70062;364;2020-11-17;20998
2020-11-16;"Prešovský kraj";226;382;51;433;NA;70062;277;2020-11-16;20634
2020-11-15;"Prešovský kraj";186;39;4;43;NA;70062;190;2020-11-15;20357
2020-11-14;"Prešovský kraj";261;54;4;58;NA;70062;265;2020-11-14;20167
2020-11-13;"Prešovský kraj";395;166;8;174;NA;70062;403;2020-11-13;19902
2020-11-12;"Prešovský kraj";397;229;50;279;NA;70062;447;2020-11-12;19499
2020-11-11;"Prešovský kraj";516;161;15;176;NA;70062;531;2020-11-11;19052
2020-11-10;"Prešovský kraj";437;197;9;206;NA;70062;446;2020-11-10;18521
2020-11-09;"Prešovský kraj";190;4106;945;5051;NA;70062;1135;2020-11-09;18075
2020-11-08;"Prešovský kraj";97;2817;32;2849;NA;70062;129;2020-11-08;16940
2020-11-07;"Prešovský kraj";416;8578;81;8659;NA;70062;497;2020-11-07;16811
2020-11-06;"Prešovský kraj";520;4791;76;4867;NA;70062;596;2020-11-06;16314
2020-11-05;"Prešovský kraj";397;180;5;185;NA;70062;402;2020-11-05;15718
2020-11-04;"Prešovský kraj";350;807;8;815;NA;70062;358;2020-11-04;15316
2020-11-03;"Prešovský kraj";565;98;12;110;NA;70062;577;2020-11-03;14958
2020-11-02;"Prešovský kraj";203;4158;1004;5162;NA;70062;1207;2020-11-02;14381
2020-11-01;"Prešovský kraj";386;2906;53;2959;NA;70062;439;2020-11-01;13174
2020-10-31;"Prešovský kraj";315;10497;170;10667;NA;70062;485;2020-10-31;12735
2020-10-30;"Prešovský kraj";552;2949;65;3014;NA;70062;617;2020-10-30;12250
2020-10-29;"Prešovský kraj";594;301;38;339;NA;70062;632;2020-10-29;11633
2020-10-28;"Prešovský kraj";617;291;46;337;NA;70062;663;2020-10-28;11001
2020-10-27;"Prešovský kraj";656;268;34;302;NA;70062;690;2020-10-27;10338
2020-10-26;"Prešovský kraj";137;363;57;420;NA;70062;194;2020-10-26;9648
2020-10-25;"Prešovský kraj";237;346;11;357;NA;70062;248;2020-10-25;9454
2020-10-24;"Prešovský kraj";719;200;12;212;NA;70062;731;2020-10-24;9206
2020-10-23;"Prešovský kraj";750;218;8;226;NA;70062;758;2020-10-23;8475
2020-10-22;"Prešovský kraj";646;396;30;426;NA;70062;676;2020-10-22;7717
2020-10-21;"Prešovský kraj";383;58;8;66;NA;70062;391;2020-10-21;7041
2020-10-20;"Prešovský kraj";493;65;7;72;NA;70062;500;2020-10-20;6650
2020-10-19;"Prešovský kraj";140;235;15;250;NA;70062;155;2020-10-19;6150
2020-10-18;"Prešovský kraj";209;0;0;0;NA;70062;209;2020-10-18;5995
2020-10-17;"Prešovský kraj";342;0;0;0;NA;70062;342;2020-10-17;5786
2020-10-16;"Prešovský kraj";388;57;3;60;NA;70062;391;2020-10-16;5444
2020-10-15;"Prešovský kraj";435;85;18;103;NA;70062;453;2020-10-15;5053
2020-10-14;"Prešovský kraj";451;54;10;64;NA;70062;461;2020-10-14;4600
2020-10-13;"Prešovský kraj";264;50;6;56;NA;70062;270;2020-10-13;4139
2020-10-12;"Prešovský kraj";214;334;35;369;NA;70062;249;2020-10-12;3869
2020-10-11;"Prešovský kraj";127;0;0;0;NA;70062;127;2020-10-11;3620
2020-10-10;"Prešovský kraj";248;0;0;0;NA;70062;248;2020-10-10;3493
2020-10-09;"Prešovský kraj";406;0;0;0;NA;70062;406;2020-10-09;3245
2020-10-08;"Prešovský kraj";245;0;0;0;NA;70062;245;2020-10-08;2839
2020-10-07;"Prešovský kraj";244;0;0;0;NA;70062;244;2020-10-07;2594
2020-10-06;"Prešovský kraj";166;0;0;0;NA;70062;166;2020-10-06;2350
2020-10-05;"Prešovský kraj";84;0;0;0;NA;70062;84;2020-10-05;2184
2020-10-04;"Prešovský kraj";118;0;0;0;NA;70062;118;2020-10-04;2100
2020-10-03;"Prešovský kraj";204;0;0;0;NA;70062;204;2020-10-03;1982
2020-10-02;"Prešovský kraj";149;0;0;0;NA;70062;149;2020-10-02;1778
2020-10-01;"Prešovský kraj";136;0;0;0;NA;70062;136;2020-10-01;1629
2020-09-30;"Prešovský kraj";121;0;0;0;NA;70062;121;2020-09-30;1493
2020-09-29;"Prešovský kraj";156;0;0;0;NA;70062;156;2020-09-29;1372
2020-09-28;"Prešovský kraj";51;0;0;0;NA;70062;51;2020-09-28;1216
2020-09-27;"Prešovský kraj";10;0;0;0;NA;70062;10;2020-09-27;1165
2020-09-26;"Prešovský kraj";72;0;0;0;NA;70062;72;2020-09-26;1155
2020-09-25;"Prešovský kraj";91;0;0;0;NA;70062;91;2020-09-25;1083
2020-09-24;"Prešovský kraj";52;0;0;0;NA;70062;52;2020-09-24;992
2020-09-23;"Prešovský kraj";55;0;0;0;NA;70062;55;2020-09-23;940
2020-09-22;"Prešovský kraj";29;0;0;0;NA;70062;29;2020-09-22;885
2020-09-21;"Prešovský kraj";14;0;0;0;NA;70062;14;2020-09-21;856
2020-09-20;"Prešovský kraj";5;0;0;0;NA;70062;5;2020-09-20;842
2020-09-19;"Prešovský kraj";12;0;0;0;NA;70062;12;2020-09-19;837
2020-09-18;"Prešovský kraj";29;0;0;0;NA;70062;29;2020-09-18;825
2020-09-17;"Prešovský kraj";25;0;0;0;NA;70062;25;2020-09-17;796
2020-09-16;"Prešovský kraj";8;0;0;0;NA;70062;8;2020-09-16;771
2020-09-15;"Prešovský kraj";10;0;0;0;NA;70062;10;2020-09-15;763
2020-09-14;"Prešovský kraj";47;0;0;0;NA;70062;47;2020-09-14;753
2020-09-13;"Prešovský kraj";3;0;0;0;NA;70062;3;2020-09-13;706
2020-09-12;"Prešovský kraj";4;0;0;0;NA;70062;4;2020-09-12;703
2020-09-11;"Prešovský kraj";15;0;0;0;NA;70062;15;2020-09-11;699
2020-09-10;"Prešovský kraj";10;0;0;0;NA;70062;10;2020-09-10;684
2020-09-09;"Prešovský kraj";21;0;0;0;NA;70062;21;2020-09-09;674
2020-09-08;"Prešovský kraj";23;0;0;0;NA;70062;23;2020-09-08;653
2020-09-07;"Prešovský kraj";5;0;0;0;NA;70062;5;2020-09-07;630
2020-09-06;"Prešovský kraj";3;0;0;0;NA;70062;3;2020-09-06;625
2020-09-05;"Prešovský kraj";7;0;0;0;NA;70062;7;2020-09-05;622
2020-09-04;"Prešovský kraj";24;0;0;0;NA;70062;24;2020-09-04;615
2020-09-03;"Prešovský kraj";8;0;0;0;NA;70062;8;2020-09-03;591
2021-02-11;"Trenčiansky kraj";291;8405;282;8687;36686;63679;573;2021-02-11;63679
2021-02-10;"Trenčiansky kraj";304;10279;298;10577;NA;63679;602;2021-02-10;63106
2021-02-09;"Trenčiansky kraj";514;21165;377;21542;NA;63679;891;2021-02-09;62504
2021-02-08;"Trenčiansky kraj";182;28247;414;28661;NA;63679;596;2021-02-08;61613
2021-02-07;"Trenčiansky kraj";31;25356;259;25615;NA;63679;290;2021-02-07;61017
2021-02-06;"Trenčiansky kraj";216;63275;580;63855;NA;63679;796;2021-02-06;60727
2021-02-05;"Trenčiansky kraj";202;17009;364;17373;NA;63679;566;2021-02-05;59931
2021-02-04;"Trenčiansky kraj";266;6891;293;7184;NA;63679;559;2021-02-04;59365
2021-02-03;"Trenčiansky kraj";162;8981;345;9326;NA;63679;507;2021-02-03;58806
2021-02-02;"Trenčiansky kraj";347;7758;379;8137;NA;63679;726;2021-02-02;58299
2021-02-01;"Trenčiansky kraj";167;18227;318;18545;NA;63679;485;2021-02-01;57573
2021-01-31;"Trenčiansky kraj";7;15791;135;15926;NA;63679;142;2021-01-31;57088
2021-01-30;"Trenčiansky kraj";228;37045;355;37400;NA;63679;583;2021-01-30;56946
2021-01-29;"Trenčiansky kraj";72;7686;207;7893;NA;63679;279;2021-01-29;56363
2021-01-28;"Trenčiansky kraj";307;5431;161;5592;NA;63679;468;2021-01-28;56084
2021-01-27;"Trenčiansky kraj";166;11735;203;11938;NA;63679;369;2021-01-27;55616
2021-01-26;"Trenčiansky kraj";303;14287;237;14524;NA;63679;540;2021-01-26;55247
2021-01-25;"Trenčiansky kraj";160;34063;366;34429;NA;63679;526;2021-01-25;54707
2021-01-24;"Trenčiansky kraj";51;27365;181;27546;NA;63679;232;2021-01-24;54181
2021-01-23;"Trenčiansky kraj";206;110039;709;110748;NA;63679;915;2021-01-23;53949
2021-01-22;"Trenčiansky kraj";148;13948;174;14122;NA;63679;322;2021-01-22;53034
2021-01-21;"Trenčiansky kraj";143;8296;187;8483;NA;63679;330;2021-01-21;52712
2021-01-20;"Trenčiansky kraj";181;7684;236;7920;NA;63679;417;2021-01-20;52382
2021-01-19;"Trenčiansky kraj";363;6462;275;6737;NA;63679;638;2021-01-19;51965
2021-01-18;"Trenčiansky kraj";72;4488;257;4745;NA;63679;329;2021-01-18;51327
2021-01-17;"Trenčiansky kraj";124;93;11;104;NA;63679;135;2021-01-17;50998
2021-01-16;"Trenčiansky kraj";39;793;62;855;NA;63679;101;2021-01-16;50863
2021-01-15;"Trenčiansky kraj";264;3777;217;3994;NA;63679;481;2021-01-15;50762
2021-01-14;"Trenčiansky kraj";275;2991;153;3144;NA;63679;428;2021-01-14;50281
2021-01-13;"Trenčiansky kraj";222;4064;236;4300;NA;63679;458;2021-01-13;49853
2021-01-12;"Trenčiansky kraj";508;4790;293;5083;NA;63679;801;2021-01-12;49395
2021-01-11;"Trenčiansky kraj";142;3885;294;4179;NA;63679;436;2021-01-11;48594
2021-01-10;"Trenčiansky kraj";89;4939;76;5015;NA;63679;165;2021-01-10;48158
2021-01-09;"Trenčiansky kraj";276;7973;121;8094;NA;63679;397;2021-01-09;47993
2021-01-08;"Trenčiansky kraj";489;6411;467;6878;NA;63679;956;2021-01-08;47596
2021-01-07;"Trenčiansky kraj";420;5719;503;6222;NA;63679;923;2021-01-07;46640
2021-01-06;"Trenčiansky kraj";221;1021;64;1085;NA;63679;285;2021-01-06;45717
2021-01-05;"Trenčiansky kraj";669;5985;800;6785;NA;63679;1469;2021-01-05;45432
2021-01-04;"Trenčiansky kraj";337;4697;704;5401;NA;63679;1041;2021-01-04;43963
2021-01-03;"Trenčiansky kraj";38;60;13;73;NA;63679;51;2021-01-03;42922
2021-01-02;"Trenčiansky kraj";129;140;23;163;NA;63679;152;2021-01-02;42871
2021-01-01;"Trenčiansky kraj";329;347;23;370;NA;63679;352;2021-01-01;42719
2020-12-31;"Trenčiansky kraj";597;4943;557;5500;NA;63679;1154;2020-12-31;42367
2020-12-30;"Trenčiansky kraj";836;6782;762;7544;NA;63679;1598;2020-12-30;41213
2020-12-29;"Trenčiansky kraj";459;5979;1018;6997;NA;63679;1477;2020-12-29;39615
2020-12-28;"Trenčiansky kraj";258;3923;777;4700;NA;63679;1035;2020-12-28;38138
2020-12-27;"Trenčiansky kraj";5;202;36;238;NA;63679;41;2020-12-27;37103
2020-12-26;"Trenčiansky kraj";174;74;10;84;NA;63679;184;2020-12-26;37062
2020-12-25;"Trenčiansky kraj";251;325;47;372;NA;63679;298;2020-12-25;36878
2020-12-24;"Trenčiansky kraj";552;2194;256;2450;NA;63679;808;2020-12-24;36580
2020-12-23;"Trenčiansky kraj";421;6305;630;6935;NA;63679;1051;2020-12-23;35772
2020-12-22;"Trenčiansky kraj";673;5610;694;6304;NA;63679;1367;2020-12-22;34721
2020-12-21;"Trenčiansky kraj";248;13562;998;14560;NA;63679;1246;2020-12-21;33354
2020-12-20;"Trenčiansky kraj";238;12480;291;12771;NA;63679;529;2020-12-20;32108
2020-12-19;"Trenčiansky kraj";341;1611;150;1761;NA;63679;491;2020-12-19;31579
2020-12-18;"Trenčiansky kraj";521;4670;543;5213;NA;63679;1064;2020-12-18;31088
2020-12-17;"Trenčiansky kraj";670;3690;503;4193;NA;63679;1173;2020-12-17;30024
2020-12-16;"Trenčiansky kraj";461;4325;622;4947;NA;63679;1083;2020-12-16;28851
2020-12-15;"Trenčiansky kraj";595;3342;629;3971;NA;63679;1224;2020-12-15;27768
2020-12-14;"Trenčiansky kraj";318;2627;598;3225;NA;63679;916;2020-12-14;26544
2020-12-13;"Trenčiansky kraj";77;24;4;28;NA;63679;81;2020-12-13;25628
2020-12-12;"Trenčiansky kraj";314;985;118;1103;NA;63679;432;2020-12-12;25547
2020-12-11;"Trenčiansky kraj";750;3643;456;4099;NA;63679;1206;2020-12-11;25115
2020-12-10;"Trenčiansky kraj";271;3371;477;3848;NA;63679;748;2020-12-10;23909
2020-12-09;"Trenčiansky kraj";508;3805;470;4275;NA;63679;978;2020-12-09;23161
2020-12-08;"Trenčiansky kraj";546;3440;522;3962;NA;63679;1068;2020-12-08;22183
2020-12-07;"Trenčiansky kraj";258;3820;466;4286;NA;63679;724;2020-12-07;21115
2020-12-06;"Trenčiansky kraj";114;179;10;189;NA;63679;124;2020-12-06;20391
2020-12-05;"Trenčiansky kraj";223;757;64;821;NA;63679;287;2020-12-05;20267
2020-12-04;"Trenčiansky kraj";253;2519;215;2734;NA;63679;468;2020-12-04;19980
2020-12-03;"Trenčiansky kraj";503;1714;178;1892;NA;63679;681;2020-12-03;19512
2020-12-02;"Trenčiansky kraj";418;1844;232;2076;NA;63679;650;2020-12-02;18831
2020-12-01;"Trenčiansky kraj";321;5642;351;5993;NA;63679;672;2020-12-01;18181
2020-11-30;"Trenčiansky kraj";167;8494;489;8983;NA;63679;656;2020-11-30;17509
2020-11-29;"Trenčiansky kraj";29;18;2;20;NA;63679;31;2020-11-29;16853
2020-11-28;"Trenčiansky kraj";202;1051;93;1144;NA;63679;295;2020-11-28;16822
2020-11-27;"Trenčiansky kraj";330;1398;150;1548;NA;63679;480;2020-11-27;16527
2020-11-26;"Trenčiansky kraj";395;1252;122;1374;NA;63679;517;2020-11-26;16047
2020-11-25;"Trenčiansky kraj";322;1444;160;1604;NA;63679;482;2020-11-25;15530
2020-11-24;"Trenčiansky kraj";348;2553;308;2861;NA;63679;656;2020-11-24;15048
2020-11-23;"Trenčiansky kraj";159;1186;122;1308;NA;63679;281;2020-11-23;14392
2020-11-22;"Trenčiansky kraj";26;11;1;12;NA;63679;27;2020-11-22;14111
2020-11-21;"Trenčiansky kraj";255;1323;62;1385;NA;63679;317;2020-11-21;14084
2020-11-20;"Trenčiansky kraj";316;861;93;954;NA;63679;409;2020-11-20;13767
2020-11-19;"Trenčiansky kraj";316;740;113;853;NA;63679;429;2020-11-19;13358
2020-11-18;"Trenčiansky kraj";233;379;66;445;NA;63679;299;2020-11-18;12929
2020-11-17;"Trenčiansky kraj";222;106;15;121;NA;63679;237;2020-11-17;12630
2020-11-16;"Trenčiansky kraj";245;236;45;281;NA;63679;290;2020-11-16;12393
2020-11-15;"Trenčiansky kraj";109;29;6;35;NA;63679;115;2020-11-15;12103
2020-11-14;"Trenčiansky kraj";190;74;11;85;NA;63679;201;2020-11-14;11988
2020-11-13;"Trenčiansky kraj";308;131;13;144;NA;63679;321;2020-11-13;11787
2020-11-12;"Trenčiansky kraj";324;124;5;129;NA;63679;329;2020-11-12;11466
2020-11-11;"Trenčiansky kraj";366;113;10;123;NA;63679;376;2020-11-11;11137
2020-11-10;"Trenčiansky kraj";277;106;6;112;NA;63679;283;2020-11-10;10761
2020-11-09;"Trenčiansky kraj";115;1407;48;1455;NA;63679;163;2020-11-09;10478
2020-11-08;"Trenčiansky kraj";81;1223;8;1231;NA;63679;89;2020-11-08;10315
2020-11-07;"Trenčiansky kraj";319;3662;59;3721;NA;63679;378;2020-11-07;10226
2020-11-06;"Trenčiansky kraj";383;6893;84;6977;NA;63679;467;2020-11-06;9848
2020-11-05;"Trenčiansky kraj";399;98;15;113;NA;63679;414;2020-11-05;9381
2020-11-04;"Trenčiansky kraj";370;91;9;100;NA;63679;379;2020-11-04;8967
2020-11-03;"Trenčiansky kraj";575;97;8;105;NA;63679;583;2020-11-03;8588
2020-11-02;"Trenčiansky kraj";197;1833;68;1901;NA;63679;265;2020-11-02;8005
2020-11-01;"Trenčiansky kraj";257;804;23;827;NA;63679;280;2020-11-01;7740
2020-10-31;"Trenčiansky kraj";332;4719;82;4801;NA;63679;414;2020-10-31;7460
2020-10-30;"Trenčiansky kraj";299;5283;102;5385;NA;63679;401;2020-10-30;7046
2020-10-29;"Trenčiansky kraj";496;764;68;832;NA;63679;564;2020-10-29;6645
2020-10-28;"Trenčiansky kraj";269;192;33;225;NA;63679;302;2020-10-28;6081
2020-10-27;"Trenčiansky kraj";473;127;27;154;NA;63679;500;2020-10-27;5779
2020-10-26;"Trenčiansky kraj";177;103;31;134;NA;63679;208;2020-10-26;5279
2020-10-25;"Trenčiansky kraj";138;9;5;14;NA;63679;143;2020-10-25;5071
2020-10-24;"Trenčiansky kraj";395;128;6;134;NA;63679;401;2020-10-24;4928
2020-10-23;"Trenčiansky kraj";301;154;8;162;NA;63679;309;2020-10-23;4527
2020-10-22;"Trenčiansky kraj";273;82;12;94;NA;63679;285;2020-10-22;4218
2020-10-21;"Trenčiansky kraj";183;53;9;62;NA;63679;192;2020-10-21;3933
2020-10-20;"Trenčiansky kraj";212;47;6;53;NA;63679;218;2020-10-20;3741
2020-10-19;"Trenčiansky kraj";41;83;25;108;NA;63679;66;2020-10-19;3523
2020-10-18;"Trenčiansky kraj";104;0;0;0;NA;63679;104;2020-10-18;3457
2020-10-17;"Trenčiansky kraj";157;0;0;0;NA;63679;157;2020-10-17;3353
2020-10-16;"Trenčiansky kraj";225;42;6;48;NA;63679;231;2020-10-16;3196
2020-10-15;"Trenčiansky kraj";255;39;4;43;NA;63679;259;2020-10-15;2965
2020-10-14;"Trenčiansky kraj";162;42;7;49;NA;63679;169;2020-10-14;2706
2020-10-13;"Trenčiansky kraj";124;105;12;117;NA;63679;136;2020-10-13;2537
2020-10-12;"Trenčiansky kraj";55;0;0;0;NA;63679;55;2020-10-12;2401
2020-10-11;"Trenčiansky kraj";73;0;0;0;NA;63679;73;2020-10-11;2346
2020-10-10;"Trenčiansky kraj";180;0;0;0;NA;63679;180;2020-10-10;2273
2020-10-09;"Trenčiansky kraj";198;0;0;0;NA;63679;198;2020-10-09;2093
2020-10-08;"Trenčiansky kraj";115;0;0;0;NA;63679;115;2020-10-08;1895
2020-10-07;"Trenčiansky kraj";75;0;0;0;NA;63679;75;2020-10-07;1780
2020-10-06;"Trenčiansky kraj";72;0;0;0;NA;63679;72;2020-10-06;1705
2020-10-05;"Trenčiansky kraj";32;0;0;0;NA;63679;32;2020-10-05;1633
2020-10-04;"Trenčiansky kraj";37;0;0;0;NA;63679;37;2020-10-04;1601
2020-10-03;"Trenčiansky kraj";79;0;0;0;NA;63679;79;2020-10-03;1564
2020-10-02;"Trenčiansky kraj";69;0;0;0;NA;63679;69;2020-10-02;1485
2020-10-01;"Trenčiansky kraj";58;0;0;0;NA;63679;58;2020-10-01;1416
2020-09-30;"Trenčiansky kraj";76;0;0;0;NA;63679;76;2020-09-30;1358
2020-09-29;"Trenčiansky kraj";43;0;0;0;NA;63679;43;2020-09-29;1282
2020-09-28;"Trenčiansky kraj";7;0;0;0;NA;63679;7;2020-09-28;1239
2020-09-27;"Trenčiansky kraj";12;0;0;0;NA;63679;12;2020-09-27;1232
2020-09-26;"Trenčiansky kraj";37;0;0;0;NA;63679;37;2020-09-26;1220
2020-09-25;"Trenčiansky kraj";72;0;0;0;NA;63679;72;2020-09-25;1183
2020-09-24;"Trenčiansky kraj";41;0;0;0;NA;63679;41;2020-09-24;1111
2020-09-23;"Trenčiansky kraj";32;0;0;0;NA;63679;32;2020-09-23;1070
2020-09-22;"Trenčiansky kraj";26;0;0;0;NA;63679;26;2020-09-22;1038
2020-09-21;"Trenčiansky kraj";23;0;0;0;NA;63679;23;2020-09-21;1012
2020-09-20;"Trenčiansky kraj";21;0;0;0;NA;63679;21;2020-09-20;989
2020-09-19;"Trenčiansky kraj";20;0;0;0;NA;63679;20;2020-09-19;968
2020-09-18;"Trenčiansky kraj";41;0;0;0;NA;63679;41;2020-09-18;948
2020-09-17;"Trenčiansky kraj";20;0;0;0;NA;63679;20;2020-09-17;907
2020-09-16;"Trenčiansky kraj";14;0;0;0;NA;63679;14;2020-09-16;887
2020-09-15;"Trenčiansky kraj";8;0;0;0;NA;63679;8;2020-09-15;873
2020-09-14;"Trenčiansky kraj";5;0;0;0;NA;63679;5;2020-09-14;865
2020-09-13;"Trenčiansky kraj";12;0;0;0;NA;63679;12;2020-09-13;860
2020-09-12;"Trenčiansky kraj";2;0;0;0;NA;63679;2;2020-09-12;848
2020-09-11;"Trenčiansky kraj";27;0;0;0;NA;63679;27;2020-09-11;846
2020-09-10;"Trenčiansky kraj";15;0;0;0;NA;63679;15;2020-09-10;819
2020-09-09;"Trenčiansky kraj";11;0;0;0;NA;63679;11;2020-09-09;804
2020-09-08;"Trenčiansky kraj";12;0;0;0;NA;63679;12;2020-09-08;793
2020-09-07;"Trenčiansky kraj";6;0;0;0;NA;63679;6;2020-09-07;781
2020-09-06;"Trenčiansky kraj";1;0;0;0;NA;63679;1;2020-09-06;775
2020-09-05;"Trenčiansky kraj";3;0;0;0;NA;63679;3;2020-09-05;774
2020-09-04;"Trenčiansky kraj";9;0;0;0;NA;63679;9;2020-09-04;771
2020-09-03;"Trenčiansky kraj";10;0;0;0;NA;63679;10;2020-09-03;762
2021-02-11;"Trnavský kraj";422;8819;279;9098;32703;61671;701;2021-02-11;61671
2021-02-10;"Trnavský kraj";511;8793;298;9091;NA;61671;809;2021-02-10;60970
2021-02-09;"Trnavský kraj";544;12714;363;13077;NA;61671;907;2021-02-09;60161
2021-02-08;"Trnavský kraj";220;33728;485;34213;NA;61671;705;2021-02-08;59254
2021-02-07;"Trnavský kraj";140;68837;627;69464;NA;61671;767;2021-02-07;58549
2021-02-06;"Trnavský kraj";348;111670;1473;113143;NA;61671;1821;2021-02-06;57782
2021-02-05;"Trnavský kraj";377;15916;354;16270;NA;61671;731;2021-02-05;55961
2021-02-04;"Trnavský kraj";456;10692;551;11243;NA;61671;1007;2021-02-04;55230
2021-02-03;"Trnavský kraj";472;6126;391;6517;NA;61671;863;2021-02-03;54223
2021-02-02;"Trnavský kraj";446;13880;414;14294;NA;61671;860;2021-02-02;53360
2021-02-01;"Trnavský kraj";198;39733;710;40443;NA;61671;908;2021-02-01;52500
2021-01-31;"Trnavský kraj";19;62728;778;63506;NA;61671;797;2021-01-31;51592
2021-01-30;"Trnavský kraj";323;110157;1268;111425;NA;61671;1591;2021-01-30;50795
2021-01-29;"Trnavský kraj";196;9563;284;9847;NA;61671;480;2021-01-29;49204
2021-01-28;"Trnavský kraj";389;5815;286;6101;NA;61671;675;2021-01-28;48724
2021-01-27;"Trnavský kraj";433;5301;219;5520;NA;61671;652;2021-01-27;48049
2021-01-26;"Trnavský kraj";565;25345;650;25995;NA;61671;1215;2021-01-26;47397
2021-01-25;"Trnavský kraj";210;43441;632;44073;NA;61671;842;2021-01-25;46182
2021-01-24;"Trnavský kraj";91;55652;703;56355;NA;61671;794;2021-01-24;45340
2021-01-23;"Trnavský kraj";372;116896;1336;118232;NA;61671;1708;2021-01-23;44546
2021-01-22;"Trnavský kraj";217;32439;500;32939;NA;61671;717;2021-01-22;42838
2021-01-21;"Trnavský kraj";311;13834;378;14212;NA;61671;689;2021-01-21;42121
2021-01-20;"Trnavský kraj";503;8149;274;8423;NA;61671;777;2021-01-20;41432
2021-01-19;"Trnavský kraj";415;7020;347;7367;NA;61671;762;2021-01-19;40655
2021-01-18;"Trnavský kraj";247;6237;484;6721;NA;61671;731;2021-01-18;39893
2021-01-17;"Trnavský kraj";128;854;215;1069;NA;61671;343;2021-01-17;39162
2021-01-16;"Trnavský kraj";103;599;19;618;NA;61671;122;2021-01-16;38819
2021-01-15;"Trnavský kraj";278;5466;336;5802;NA;61671;614;2021-01-15;38697
2021-01-14;"Trnavský kraj";452;3994;337;4331;NA;61671;789;2021-01-14;38083
2021-01-13;"Trnavský kraj";457;4752;378;5130;NA;61671;835;2021-01-13;37294
2021-01-12;"Trnavský kraj";469;7177;483;7660;NA;61671;952;2021-01-12;36459
2021-01-11;"Trnavský kraj";370;4911;376;5287;NA;61671;746;2021-01-11;35507
2021-01-10;"Trnavský kraj";71;8;0;8;NA;61671;71;2021-01-10;34761
2021-01-09;"Trnavský kraj";417;1775;100;1875;NA;61671;517;2021-01-09;34690
2021-01-08;"Trnavský kraj";381;6349;502;6851;NA;61671;883;2021-01-08;34173
2021-01-07;"Trnavský kraj";501;4074;397;4471;NA;61671;898;2021-01-07;33290
2021-01-06;"Trnavský kraj";179;758;132;890;NA;61671;311;2021-01-06;32392
2021-01-05;"Trnavský kraj";611;6188;705;6893;NA;61671;1316;2021-01-05;32081
2021-01-04;"Trnavský kraj";302;5235;689;5924;NA;61671;991;2021-01-04;30765
2021-01-03;"Trnavský kraj";60;51;7;58;NA;61671;67;2021-01-03;29774
2021-01-02;"Trnavský kraj";282;412;30;442;NA;61671;312;2021-01-02;29707
2021-01-01;"Trnavský kraj";143;449;76;525;NA;61671;219;2021-01-01;29395
2020-12-31;"Trnavský kraj";498;8474;856;9330;NA;61671;1354;2020-12-31;29176
2020-12-30;"Trnavský kraj";785;5319;610;5929;NA;61671;1395;2020-12-30;27822
2020-12-29;"Trnavský kraj";322;5003;593;5596;NA;61671;915;2020-12-29;26427
2020-12-28;"Trnavský kraj";213;5339;615;5954;NA;61671;828;2020-12-28;25512
2020-12-27;"Trnavský kraj";27;13;4;17;NA;61671;31;2020-12-27;24684
2020-12-26;"Trnavský kraj";148;44;1;45;NA;61671;149;2020-12-26;24653
2020-12-25;"Trnavský kraj";65;49;5;54;NA;61671;70;2020-12-25;24504
2020-12-24;"Trnavský kraj";333;1359;117;1476;NA;61671;450;2020-12-24;24434
2020-12-23;"Trnavský kraj";210;6417;375;6792;NA;61671;585;2020-12-23;23984
2020-12-22;"Trnavský kraj";311;5590;491;6081;NA;61671;802;2020-12-22;23399
2020-12-21;"Trnavský kraj";328;4527;399;4926;NA;61671;727;2020-12-21;22597
2020-12-20;"Trnavský kraj";134;110;12;122;NA;61671;146;2020-12-20;21870
2020-12-19;"Trnavský kraj";201;1046;86;1132;NA;61671;287;2020-12-19;21724
2020-12-18;"Trnavský kraj";341;4898;378;5276;NA;61671;719;2020-12-18;21437
2020-12-17;"Trnavský kraj";375;4996;407;5403;NA;61671;782;2020-12-17;20718
2020-12-16;"Trnavský kraj";312;5249;405;5654;NA;61671;717;2020-12-16;19936
2020-12-15;"Trnavský kraj";492;6622;632;7254;NA;61671;1124;2020-12-15;19219
2020-12-14;"Trnavský kraj";161;3505;292;3797;NA;61671;453;2020-12-14;18095
2020-12-13;"Trnavský kraj";7;0;0;0;NA;61671;7;2020-12-13;17642
2020-12-12;"Trnavský kraj";254;1456;114;1570;NA;61671;368;2020-12-12;17635
2020-12-11;"Trnavský kraj";384;4683;262;4945;NA;61671;646;2020-12-11;17267
2020-12-10;"Trnavský kraj";183;5194;320;5514;NA;61671;503;2020-12-10;16621
2020-12-09;"Trnavský kraj";521;4272;320;4592;NA;61671;841;2020-12-09;16118
2020-12-08;"Trnavský kraj";281;4090;304;4394;NA;61671;585;2020-12-08;15277
2020-12-07;"Trnavský kraj";178;2895;199;3094;NA;61671;377;2020-12-07;14692
2020-12-06;"Trnavský kraj";46;0;0;0;NA;61671;46;2020-12-06;14315
2020-12-05;"Trnavský kraj";129;2218;41;2259;NA;61671;170;2020-12-05;14269
2020-12-04;"Trnavský kraj";242;3948;158;4106;NA;61671;400;2020-12-04;14099
2020-12-03;"Trnavský kraj";248;2770;190;2960;NA;61671;438;2020-12-03;13699
2020-12-02;"Trnavský kraj";284;4516;176;4692;NA;61671;460;2020-12-02;13261
2020-12-01;"Trnavský kraj";253;3190;205;3395;NA;61671;458;2020-12-01;12801
2020-11-30;"Trnavský kraj";200;7360;186;7546;NA;61671;386;2020-11-30;12343
2020-11-29;"Trnavský kraj";17;708;34;742;NA;61671;51;2020-11-29;11957
2020-11-28;"Trnavský kraj";83;1453;77;1530;NA;61671;160;2020-11-28;11906
2020-11-27;"Trnavský kraj";148;1591;83;1674;NA;61671;231;2020-11-27;11746
2020-11-26;"Trnavský kraj";234;985;59;1044;NA;61671;293;2020-11-26;11515
2020-11-25;"Trnavský kraj";232;1029;72;1101;NA;61671;304;2020-11-25;11222
2020-11-24;"Trnavský kraj";295;1772;91;1863;NA;61671;386;2020-11-24;10918
2020-11-23;"Trnavský kraj";242;7207;125;7332;NA;61671;367;2020-11-23;10532
2020-11-22;"Trnavský kraj";10;54;3;57;NA;61671;13;2020-11-22;10165
2020-11-21;"Trnavský kraj";129;1214;23;1237;NA;61671;152;2020-11-21;10152
2020-11-20;"Trnavský kraj";246;1027;61;1088;NA;61671;307;2020-11-20;10000
2020-11-19;"Trnavský kraj";157;694;58;752;NA;61671;215;2020-11-19;9693
2020-11-18;"Trnavský kraj";235;716;75;791;NA;61671;310;2020-11-18;9478
2020-11-17;"Trnavský kraj";129;695;72;767;NA;61671;201;2020-11-17;9168
2020-11-16;"Trnavský kraj";187;682;32;714;NA;61671;219;2020-11-16;8967
2020-11-15;"Trnavský kraj";23;73;4;77;NA;61671;27;2020-11-15;8748
2020-11-14;"Trnavský kraj";86;389;10;399;NA;61671;96;2020-11-14;8721
2020-11-13;"Trnavský kraj";219;1312;21;1333;NA;61671;240;2020-11-13;8625
2020-11-12;"Trnavský kraj";162;420;18;438;NA;61671;180;2020-11-12;8385
2020-11-11;"Trnavský kraj";257;392;15;407;NA;61671;272;2020-11-11;8205
2020-11-10;"Trnavský kraj";189;889;30;919;NA;61671;219;2020-11-10;7933
2020-11-09;"Trnavský kraj";196;369;23;392;NA;61671;219;2020-11-09;7714
2020-11-08;"Trnavský kraj";55;306;4;310;NA;61671;59;2020-11-08;7495
2020-11-07;"Trnavský kraj";207;6070;74;6144;NA;61671;281;2020-11-07;7436
2020-11-06;"Trnavský kraj";260;1531;19;1550;NA;61671;279;2020-11-06;7155
2020-11-05;"Trnavský kraj";150;220;27;247;NA;61671;177;2020-11-05;6876
2020-11-04;"Trnavský kraj";188;212;10;222;NA;61671;198;2020-11-04;6699
2020-11-03;"Trnavský kraj";317;127;8;135;NA;61671;325;2020-11-03;6501
2020-11-02;"Trnavský kraj";281;1728;31;1759;NA;61671;312;2020-11-02;6176
2020-11-01;"Trnavský kraj";87;494;27;521;NA;61671;114;2020-11-01;5864
2020-10-31;"Trnavský kraj";259;5024;41;5065;NA;61671;300;2020-10-31;5750
2020-10-30;"Trnavský kraj";198;3784;27;3811;NA;61671;225;2020-10-30;5450
2020-10-29;"Trnavský kraj";273;1461;16;1477;NA;61671;289;2020-10-29;5225
2020-10-28;"Trnavský kraj";319;117;16;133;NA;61671;335;2020-10-28;4936
2020-10-27;"Trnavský kraj";199;461;36;497;NA;61671;235;2020-10-27;4601
2020-10-26;"Trnavský kraj";153;29;2;31;NA;61671;155;2020-10-26;4366
2020-10-25;"Trnavský kraj";95;19;1;20;NA;61671;96;2020-10-25;4211
2020-10-24;"Trnavský kraj";158;109;2;111;NA;61671;160;2020-10-24;4115
2020-10-23;"Trnavský kraj";201;89;4;93;NA;61671;205;2020-10-23;3955
2020-10-22;"Trnavský kraj";195;55;2;57;NA;61671;197;2020-10-22;3750
2020-10-21;"Trnavský kraj";134;73;3;76;NA;61671;137;2020-10-21;3553
2020-10-20;"Trnavský kraj";202;82;3;85;NA;61671;205;2020-10-20;3416
2020-10-19;"Trnavský kraj";67;55;0;55;NA;61671;67;2020-10-19;3211
2020-10-18;"Trnavský kraj";84;0;0;0;NA;61671;84;2020-10-18;3144
2020-10-17;"Trnavský kraj";123;0;0;0;NA;61671;123;2020-10-17;3060
2020-10-16;"Trnavský kraj";86;45;2;47;NA;61671;88;2020-10-16;2937
2020-10-15;"Trnavský kraj";155;66;2;68;NA;61671;157;2020-10-15;2849
2020-10-14;"Trnavský kraj";236;468;3;471;NA;61671;239;2020-10-14;2692
2020-10-13;"Trnavský kraj";138;16;2;18;NA;61671;140;2020-10-13;2453
2020-10-12;"Trnavský kraj";33;41;1;42;NA;61671;34;2020-10-12;2313
2020-10-11;"Trnavský kraj";31;0;0;0;NA;61671;31;2020-10-11;2279
2020-10-10;"Trnavský kraj";128;0;0;0;NA;61671;128;2020-10-10;2248
2020-10-09;"Trnavský kraj";156;0;0;0;NA;61671;156;2020-10-09;2120
2020-10-08;"Trnavský kraj";153;0;0;0;NA;61671;153;2020-10-08;1964
2020-10-07;"Trnavský kraj";80;0;0;0;NA;61671;80;2020-10-07;1811
2020-10-06;"Trnavský kraj";112;0;0;0;NA;61671;112;2020-10-06;1731
2020-10-05;"Trnavský kraj";33;0;0;0;NA;61671;33;2020-10-05;1619
2020-10-04;"Trnavský kraj";44;0;0;0;NA;61671;44;2020-10-04;1586
2020-10-03;"Trnavský kraj";60;0;0;0;NA;61671;60;2020-10-03;1542
2020-10-02;"Trnavský kraj";41;0;0;0;NA;61671;41;2020-10-02;1482
2020-10-01;"Trnavský kraj";53;0;0;0;NA;61671;53;2020-10-01;1441
2020-09-30;"Trnavský kraj";91;0;0;0;NA;61671;91;2020-09-30;1388
2020-09-29;"Trnavský kraj";40;0;0;0;NA;61671;40;2020-09-29;1297
2020-09-28;"Trnavský kraj";69;0;0;0;NA;61671;69;2020-09-28;1257
2020-09-27;"Trnavský kraj";30;0;0;0;NA;61671;30;2020-09-27;1188
2020-09-26;"Trnavský kraj";46;0;0;0;NA;61671;46;2020-09-26;1158
2020-09-25;"Trnavský kraj";32;0;0;0;NA;61671;32;2020-09-25;1112
2020-09-24;"Trnavský kraj";42;0;0;0;NA;61671;42;2020-09-24;1080
2020-09-23;"Trnavský kraj";43;0;0;0;NA;61671;43;2020-09-23;1038
2020-09-22;"Trnavský kraj";55;0;0;0;NA;61671;55;2020-09-22;995
2020-09-21;"Trnavský kraj";41;0;0;0;NA;61671;41;2020-09-21;940
2020-09-20;"Trnavský kraj";17;0;0;0;NA;61671;17;2020-09-20;899
2020-09-19;"Trnavský kraj";4;0;0;0;NA;61671;4;2020-09-19;882
2020-09-18;"Trnavský kraj";33;0;0;0;NA;61671;33;2020-09-18;878
2020-09-17;"Trnavský kraj";42;0;0;0;NA;61671;42;2020-09-17;845
2020-09-16;"Trnavský kraj";49;0;0;0;NA;61671;49;2020-09-16;803
2020-09-15;"Trnavský kraj";5;0;0;0;NA;61671;5;2020-09-15;754
2020-09-14;"Trnavský kraj";26;0;0;0;NA;61671;26;2020-09-14;749
2020-09-13;"Trnavský kraj";9;0;0;0;NA;61671;9;2020-09-13;723
2020-09-12;"Trnavský kraj";12;0;0;0;NA;61671;12;2020-09-12;714
2020-09-11;"Trnavský kraj";16;0;0;0;NA;61671;16;2020-09-11;702
2020-09-10;"Trnavský kraj";32;0;0;0;NA;61671;32;2020-09-10;686
2020-09-09;"Trnavský kraj";14;0;0;0;NA;61671;14;2020-09-09;654
2020-09-08;"Trnavský kraj";11;0;0;0;NA;61671;11;2020-09-08;640
2020-09-07;"Trnavský kraj";7;0;0;0;NA;61671;7;2020-09-07;629
2020-09-06;"Trnavský kraj";5;0;0;0;NA;61671;5;2020-09-06;622
2020-09-05;"Trnavský kraj";7;0;0;0;NA;61671;7;2020-09-05;617
2020-09-04;"Trnavský kraj";16;0;0;0;NA;61671;16;2020-09-04;610
2020-09-03;"Trnavský kraj";8;0;0;0;NA;61671;8;2020-09-03;594
2021-02-11;"Žilinský kraj";228;16915;210;17125;38672;64702;438;2021-02-11;64702
2021-02-10;"Žilinský kraj";259;16536;257;16793;NA;64702;516;2021-02-10;64264
2021-02-09;"Žilinský kraj";377;23657;271;23928;NA;64702;648;2021-02-09;63748
2021-02-08;"Žilinský kraj";160;43952;411;44363;NA;64702;571;2021-02-08;63100
2021-02-07;"Žilinský kraj";24;38440;199;38639;NA;64702;223;2021-02-07;62529
2021-02-06;"Žilinský kraj";71;65071;322;65393;NA;64702;393;2021-02-06;62306
2021-02-05;"Žilinský kraj";248;30773;297;31070;NA;64702;545;2021-02-05;61913
2021-02-04;"Žilinský kraj";238;11307;232;11539;NA;64702;470;2021-02-04;61368
2021-02-03;"Žilinský kraj";194;8750;252;9002;NA;64702;446;2021-02-03;60898
2021-02-02;"Žilinský kraj";216;9807;280;10087;NA;64702;496;2021-02-02;60452
2021-02-01;"Žilinský kraj";220;18627;334;18961;NA;64702;554;2021-02-01;59956
2021-01-31;"Žilinský kraj";11;42;1;43;NA;64702;12;2021-01-31;59402
2021-01-30;"Žilinský kraj";85;15377;156;15533;NA;64702;241;2021-01-30;59390
2021-01-29;"Žilinský kraj";30;17212;214;17426;NA;64702;244;2021-01-29;59149
2021-01-28;"Žilinský kraj";240;5598;174;5772;NA;64702;414;2021-01-28;58905
2021-01-27;"Žilinský kraj";256;6977;123;7100;NA;64702;379;2021-01-27;58491
2021-01-26;"Žilinský kraj";245;49404;342;49746;NA;64702;587;2021-01-26;58112
2021-01-25;"Žilinský kraj";159;18615;131;18746;NA;64702;290;2021-01-25;57525
2021-01-24;"Žilinský kraj";22;32472;138;32610;NA;64702;160;2021-01-24;57235
2021-01-23;"Žilinský kraj";91;88106;395;88501;NA;64702;486;2021-01-23;57075
2021-01-22;"Žilinský kraj";163;28047;228;28275;NA;64702;391;2021-01-22;56589
2021-01-21;"Žilinský kraj";116;19351;178;19529;NA;64702;294;2021-01-21;56198
2021-01-20;"Žilinský kraj";236;16958;165;17123;NA;64702;401;2021-01-20;55904
2021-01-19;"Žilinský kraj";245;17570;405;17975;NA;64702;650;2021-01-19;55503
2021-01-18;"Žilinský kraj";236;12487;334;12821;NA;64702;570;2021-01-18;54853
2021-01-17;"Žilinský kraj";95;113;2;115;NA;64702;97;2021-01-17;54283
2021-01-16;"Žilinský kraj";14;314;8;322;NA;64702;22;2021-01-16;54186
2021-01-15;"Žilinský kraj";248;7149;202;7351;NA;64702;450;2021-01-15;54164
2021-01-14;"Žilinský kraj";166;5637;253;5890;NA;64702;419;2021-01-14;53714
2021-01-13;"Žilinský kraj";247;11341;554;11895;NA;64702;801;2021-01-13;53295
2021-01-12;"Žilinský kraj";376;8924;426;9350;NA;64702;802;2021-01-12;52494
2021-01-11;"Žilinský kraj";351;10485;510;10995;NA;64702;861;2021-01-11;51692
2021-01-10;"Žilinský kraj";38;189;7;196;NA;64702;45;2021-01-10;50831
2021-01-09;"Žilinský kraj";192;1992;85;2077;NA;64702;277;2021-01-09;50786
2021-01-08;"Žilinský kraj";413;9352;511;9863;NA;64702;924;2021-01-08;50509
2021-01-07;"Žilinský kraj";438;23644;1880;25524;NA;64702;2318;2021-01-07;49585
2021-01-06;"Žilinský kraj";145;1338;89;1427;NA;64702;234;2021-01-06;47267
2021-01-05;"Žilinský kraj";717;11310;929;12239;NA;64702;1646;2021-01-05;47033
2021-01-04;"Žilinský kraj";479;9549;949;10498;NA;64702;1428;2021-01-04;45387
2021-01-03;"Žilinský kraj";13;33;4;37;NA;64702;17;2021-01-03;43959
2021-01-02;"Žilinský kraj";98;746;86;832;NA;64702;184;2021-01-02;43942
2021-01-01;"Žilinský kraj";118;552;36;588;NA;64702;154;2021-01-01;43758
2020-12-31;"Žilinský kraj";395;10587;835;11422;NA;64702;1230;2020-12-31;43604
2020-12-30;"Žilinský kraj";1038;12450;914;13364;NA;64702;1952;2020-12-30;42374
2020-12-29;"Žilinský kraj";256;11104;1111;12215;NA;64702;1367;2020-12-29;40422
2020-12-28;"Žilinský kraj";406;10770;1002;11772;NA;64702;1408;2020-12-28;39055
2020-12-27;"Žilinský kraj";40;662;80;742;NA;64702;120;2020-12-27;37647
2020-12-26;"Žilinský kraj";135;124;14;138;NA;64702;149;2020-12-26;37527
2020-12-25;"Žilinský kraj";66;111;10;121;NA;64702;76;2020-12-25;37378
2020-12-24;"Žilinský kraj";643;1018;75;1093;NA;64702;718;2020-12-24;37302
2020-12-23;"Žilinský kraj";228;17718;1049;18767;NA;64702;1277;2020-12-23;36584
2020-12-22;"Žilinský kraj";519;13188;1023;14211;NA;64702;1542;2020-12-22;35307
2020-12-21;"Žilinský kraj";444;12703;1107;13810;NA;64702;1551;2020-12-21;33765
2020-12-20;"Žilinský kraj";36;579;73;652;NA;64702;109;2020-12-20;32214
2020-12-19;"Žilinský kraj";208;2080;144;2224;NA;64702;352;2020-12-19;32105
2020-12-18;"Žilinský kraj";333;7027;402;7429;NA;64702;735;2020-12-18;31753
2020-12-17;"Žilinský kraj";500;4333;281;4614;NA;64702;781;2020-12-17;31018
2020-12-16;"Žilinský kraj";333;4365;305;4670;NA;64702;638;2020-12-16;30237
2020-12-15;"Žilinský kraj";528;4700;414;5114;NA;64702;942;2020-12-15;29599
2020-12-14;"Žilinský kraj";321;4688;419;5107;NA;64702;740;2020-12-14;28657
2020-12-13;"Žilinský kraj";26;515;64;579;NA;64702;90;2020-12-13;27917
2020-12-12;"Žilinský kraj";95;1061;53;1114;NA;64702;148;2020-12-12;27827
2020-12-11;"Žilinský kraj";455;5089;318;5407;NA;64702;773;2020-12-11;27679
2020-12-10;"Žilinský kraj";166;9279;977;10256;NA;64702;1143;2020-12-10;26906
2020-12-09;"Žilinský kraj";392;2570;164;2734;NA;64702;556;2020-12-09;25763
2020-12-08;"Žilinský kraj";331;3915;188;4103;NA;64702;519;2020-12-08;25207
2020-12-07;"Žilinský kraj";348;2274;121;2395;NA;64702;469;2020-12-07;24688
2020-12-06;"Žilinský kraj";15;134;4;138;NA;64702;19;2020-12-06;24219
2020-12-05;"Žilinský kraj";98;1237;45;1282;NA;64702;143;2020-12-05;24200
2020-12-04;"Žilinský kraj";228;2847;120;2967;NA;64702;348;2020-12-04;24057
2020-12-03;"Žilinský kraj";237;1412;119;1531;NA;64702;356;2020-12-03;23709
2020-12-02;"Žilinský kraj";181;1553;82;1635;NA;64702;263;2020-12-02;23353
2020-12-01;"Žilinský kraj";209;6529;309;6838;NA;64702;518;2020-12-01;23090
2020-11-30;"Žilinský kraj";202;5232;291;5523;NA;64702;493;2020-11-30;22572
2020-11-29;"Žilinský kraj";18;81;7;88;NA;64702;25;2020-11-29;22079
2020-11-28;"Žilinský kraj";99;349;15;364;NA;64702;114;2020-11-28;22054
2020-11-27;"Žilinský kraj";218;913;46;959;NA;64702;264;2020-11-27;21940
2020-11-26;"Žilinský kraj";189;1104;57;1161;NA;64702;246;2020-11-26;21676
2020-11-25;"Žilinský kraj";225;1217;49;1266;NA;64702;274;2020-11-25;21430
2020-11-24;"Žilinský kraj";213;2092;67;2159;NA;64702;280;2020-11-24;21156
2020-11-23;"Žilinský kraj";170;759;44;803;NA;64702;214;2020-11-23;20876
2020-11-22;"Žilinský kraj";11;0;0;0;NA;64702;11;2020-11-22;20662
2020-11-21;"Žilinský kraj";61;505;20;525;NA;64702;81;2020-11-21;20651
2020-11-20;"Žilinský kraj";251;1074;45;1119;NA;64702;296;2020-11-20;20570
2020-11-19;"Žilinský kraj";252;752;61;813;NA;64702;313;2020-11-19;20274
2020-11-18;"Žilinský kraj";346;348;15;363;NA;64702;361;2020-11-18;19961
2020-11-17;"Žilinský kraj";123;490;15;505;NA;64702;138;2020-11-17;19600
2020-11-16;"Žilinský kraj";227;206;13;219;NA;64702;240;2020-11-16;19462
2020-11-15;"Žilinský kraj";63;13;0;13;NA;64702;63;2020-11-15;19222
2020-11-14;"Žilinský kraj";189;1038;11;1049;NA;64702;200;2020-11-14;19159
2020-11-13;"Žilinský kraj";181;125;9;134;NA;64702;190;2020-11-13;18959
2020-11-12;"Žilinský kraj";334;79;2;81;NA;64702;336;2020-11-12;18769
2020-11-11;"Žilinský kraj";489;147;10;157;NA;64702;499;2020-11-11;18433
2020-11-10;"Žilinský kraj";374;519;9;528;NA;64702;383;2020-11-10;17934
2020-11-09;"Žilinský kraj";143;2335;30;2365;NA;64702;173;2020-11-09;17551
2020-11-08;"Žilinský kraj";59;2196;35;2231;NA;64702;94;2020-11-08;17378
2020-11-07;"Žilinský kraj";312;8175;88;8263;NA;64702;400;2020-11-07;17284
2020-11-06;"Žilinský kraj";503;4090;38;4128;NA;64702;541;2020-11-06;16884
2020-11-05;"Žilinský kraj";473;64;4;68;NA;64702;477;2020-11-05;16343
2020-11-04;"Žilinský kraj";423;168;10;178;NA;64702;433;2020-11-04;15866
2020-11-03;"Žilinský kraj";688;889;16;905;NA;64702;704;2020-11-03;15433
2020-11-02;"Žilinský kraj";472;1043;39;1082;NA;64702;511;2020-11-02;14729
2020-11-01;"Žilinský kraj";349;5096;130;5226;NA;64702;479;2020-11-01;14218
2020-10-31;"Žilinský kraj";662;7963;203;8166;NA;64702;865;2020-10-31;13739
2020-10-30;"Žilinský kraj";529;2575;61;2636;NA;64702;590;2020-10-30;12874
2020-10-29;"Žilinský kraj";740;503;17;520;NA;64702;757;2020-10-29;12284
2020-10-28;"Žilinský kraj";635;105;11;116;NA;64702;646;2020-10-28;11527
2020-10-27;"Žilinský kraj";355;154;24;178;NA;64702;379;2020-10-27;10881
2020-10-26;"Žilinský kraj";148;117;28;145;NA;64702;176;2020-10-26;10502
2020-10-25;"Žilinský kraj";436;0;0;0;NA;64702;436;2020-10-25;10326
2020-10-24;"Žilinský kraj";803;0;0;0;NA;64702;803;2020-10-24;9890
2020-10-23;"Žilinský kraj";659;102;13;115;NA;64702;672;2020-10-23;9087
2020-10-22;"Žilinský kraj";525;33;3;36;NA;64702;528;2020-10-22;8415
2020-10-21;"Žilinský kraj";478;74;14;88;NA;64702;492;2020-10-21;7887
2020-10-20;"Žilinský kraj";524;127;8;135;NA;64702;532;2020-10-20;7395
2020-10-19;"Žilinský kraj";70;80;12;92;NA;64702;82;2020-10-19;6863
2020-10-18;"Žilinský kraj";159;0;0;0;NA;64702;159;2020-10-18;6781
2020-10-17;"Žilinský kraj";509;0;0;0;NA;64702;509;2020-10-17;6622
2020-10-16;"Žilinský kraj";603;51;9;60;NA;64702;612;2020-10-16;6113
2020-10-15;"Žilinský kraj";679;61;3;64;NA;64702;682;2020-10-15;5501
2020-10-14;"Žilinský kraj";523;269;6;275;NA;64702;529;2020-10-14;4819
2020-10-13;"Žilinský kraj";367;458;40;498;NA;64702;407;2020-10-13;4290
2020-10-12;"Žilinský kraj";62;0;0;0;NA;64702;62;2020-10-12;3883
2020-10-11;"Žilinský kraj";50;0;0;0;NA;64702;50;2020-10-11;3821
2020-10-10;"Žilinský kraj";213;0;0;0;NA;64702;213;2020-10-10;3771
2020-10-09;"Žilinský kraj";543;0;0;0;NA;64702;543;2020-10-09;3558
2020-10-08;"Žilinský kraj";238;0;0;0;NA;64702;238;2020-10-08;3015
2020-10-07;"Žilinský kraj";168;0;0;0;NA;64702;168;2020-10-07;2777
2020-10-06;"Žilinský kraj";233;0;0;0;NA;64702;233;2020-10-06;2609
2020-10-05;"Žilinský kraj";33;0;0;0;NA;64702;33;2020-10-05;2376
2020-10-04;"Žilinský kraj";35;0;0;0;NA;64702;35;2020-10-04;2343
2020-10-03;"Žilinský kraj";155;0;0;0;NA;64702;155;2020-10-03;2308
2020-10-02;"Žilinský kraj";105;0;0;0;NA;64702;105;2020-10-02;2153
2020-10-01;"Žilinský kraj";147;0;0;0;NA;64702;147;2020-10-01;2048
2020-09-30;"Žilinský kraj";163;0;0;0;NA;64702;163;2020-09-30;1901
2020-09-29;"Žilinský kraj";105;0;0;0;NA;64702;105;2020-09-29;1738
2020-09-28;"Žilinský kraj";34;0;0;0;NA;64702;34;2020-09-28;1633
2020-09-27;"Žilinský kraj";108;0;0;0;NA;64702;108;2020-09-27;1599
2020-09-26;"Žilinský kraj";96;0;0;0;NA;64702;96;2020-09-26;1491
2020-09-25;"Žilinský kraj";69;0;0;0;NA;64702;69;2020-09-25;1395
2020-09-24;"Žilinský kraj";100;0;0;0;NA;64702;100;2020-09-24;1326
2020-09-23;"Žilinský kraj";65;0;0;0;NA;64702;65;2020-09-23;1226
2020-09-22;"Žilinský kraj";65;0;0;0;NA;64702;65;2020-09-22;1161
2020-09-21;"Žilinský kraj";47;0;0;0;NA;64702;47;2020-09-21;1096
2020-09-20;"Žilinský kraj";4;0;0;0;NA;64702;4;2020-09-20;1049
2020-09-19;"Žilinský kraj";6;0;0;0;NA;64702;6;2020-09-19;1045
2020-09-18;"Žilinský kraj";82;0;0;0;NA;64702;82;2020-09-18;1039
2020-09-17;"Žilinský kraj";30;0;0;0;NA;64702;30;2020-09-17;957
2020-09-16;"Žilinský kraj";34;0;0;0;NA;64702;34;2020-09-16;927
2020-09-15;"Žilinský kraj";12;0;0;0;NA;64702;12;2020-09-15;893
2020-09-14;"Žilinský kraj";39;0;0;0;NA;64702;39;2020-09-14;881
2020-09-13;"Žilinský kraj";6;0;0;0;NA;64702;6;2020-09-13;842
2020-09-12;"Žilinský kraj";4;0;0;0;NA;64702;4;2020-09-12;836
2020-09-11;"Žilinský kraj";31;0;0;0;NA;64702;31;2020-09-11;832
2020-09-10;"Žilinský kraj";31;0;0;0;NA;64702;31;2020-09-10;801
2020-09-09;"Žilinský kraj";23;0;0;0;NA;64702;23;2020-09-09;770
2020-09-08;"Žilinský kraj";25;0;0;0;NA;64702;25;2020-09-08;747
2020-09-07;"Žilinský kraj";11;0;0;0;NA;64702;11;2020-09-07;722
2020-09-05;"Žilinský kraj";2;0;0;0;NA;64702;2;2020-09-05;711
2020-09-04;"Žilinský kraj";33;0;0;0;NA;64702;33;2020-09-04;709
2020-09-03;"Žilinský kraj";18;0;0;0;NA;64702;18;2020-09-03;676
